Time,KEYS,Licenses,RunningSum,Area,Arabic
1963,93,0,0,JUMEIRA FIRST,جميرا الأولى
1964,93,0,0,JUMEIRA FIRST,جميرا الأولى
1965,93,0,0,JUMEIRA FIRST,جميرا الأولى
1966,93,0,0,JUMEIRA FIRST,جميرا الأولى
1967,93,0,0,JUMEIRA FIRST,جميرا الأولى
1968,93,0,0,JUMEIRA FIRST,جميرا الأولى
1969,93,0,0,JUMEIRA FIRST,جميرا الأولى
1970,93,1,1,JUMEIRA FIRST,جميرا الأولى
1971,93,1,2,JUMEIRA FIRST,جميرا الأولى
1972,93,0,2,JUMEIRA FIRST,جميرا الأولى
1973,93,0,2,JUMEIRA FIRST,جميرا الأولى
1974,93,2,4,JUMEIRA FIRST,جميرا الأولى
1975,93,2,6,JUMEIRA FIRST,جميرا الأولى
1976,93,3,9,JUMEIRA FIRST,جميرا الأولى
1977,93,3,12,JUMEIRA FIRST,جميرا الأولى
1978,93,1,13,JUMEIRA FIRST,جميرا الأولى
1979,93,4,17,JUMEIRA FIRST,جميرا الأولى
1980,93,5,22,JUMEIRA FIRST,جميرا الأولى
1981,93,4,26,JUMEIRA FIRST,جميرا الأولى
1982,93,4,30,JUMEIRA FIRST,جميرا الأولى
1983,93,2,32,JUMEIRA FIRST,جميرا الأولى
1984,93,4,36,JUMEIRA FIRST,جميرا الأولى
1985,93,3,39,JUMEIRA FIRST,جميرا الأولى
1986,93,3,42,JUMEIRA FIRST,جميرا الأولى
1987,93,2,44,JUMEIRA FIRST,جميرا الأولى
1988,93,10,54,JUMEIRA FIRST,جميرا الأولى
1989,93,5,59,JUMEIRA FIRST,جميرا الأولى
1990,93,6,65,JUMEIRA FIRST,جميرا الأولى
1991,93,4,69,JUMEIRA FIRST,جميرا الأولى
1992,93,8,77,JUMEIRA FIRST,جميرا الأولى
1993,93,7,84,JUMEIRA FIRST,جميرا الأولى
1994,93,9,93,JUMEIRA FIRST,جميرا الأولى
1995,93,6,99,JUMEIRA FIRST,جميرا الأولى
1996,93,7,106,JUMEIRA FIRST,جميرا الأولى
1997,93,19,125,JUMEIRA FIRST,جميرا الأولى
1998,93,8,133,JUMEIRA FIRST,جميرا الأولى
1999,93,25,158,JUMEIRA FIRST,جميرا الأولى
2000,93,23,181,JUMEIRA FIRST,جميرا الأولى
2001,93,23,204,JUMEIRA FIRST,جميرا الأولى
2002,93,40,244,JUMEIRA FIRST,جميرا الأولى
2003,93,22,266,JUMEIRA FIRST,جميرا الأولى
2004,93,46,312,JUMEIRA FIRST,جميرا الأولى
2005,93,12,324,JUMEIRA FIRST,جميرا الأولى
2006,93,20,344,JUMEIRA FIRST,جميرا الأولى
2007,93,23,367,JUMEIRA FIRST,جميرا الأولى
2008,93,41,408,JUMEIRA FIRST,جميرا الأولى
2009,93,30,438,JUMEIRA FIRST,جميرا الأولى
2010,93,37,475,JUMEIRA FIRST,جميرا الأولى
2011,93,37,512,JUMEIRA FIRST,جميرا الأولى
2012,93,44,556,JUMEIRA FIRST,جميرا الأولى
2013,93,39,595,JUMEIRA FIRST,جميرا الأولى
2014,93,42,637,JUMEIRA FIRST,جميرا الأولى
2015,93,45,682,JUMEIRA FIRST,جميرا الأولى
2016,93,51,733,JUMEIRA FIRST,جميرا الأولى
2017,93,77,810,JUMEIRA FIRST,جميرا الأولى
2018,93,84,894,JUMEIRA FIRST,جميرا الأولى
2019,93,165,1059,JUMEIRA FIRST,جميرا الأولى
2020,93,265,1324,JUMEIRA FIRST,جميرا الأولى
2021,93,0,1324,JUMEIRA FIRST,جميرا الأولى
1963,213,7,7,AL QUSAIS FIRST,القصيص الأولى
1964,213,1,8,AL QUSAIS FIRST,القصيص الأولى
1965,213,1,9,AL QUSAIS FIRST,القصيص الأولى
1966,213,2,11,AL QUSAIS FIRST,القصيص الأولى
1967,213,0,11,AL QUSAIS FIRST,القصيص الأولى
1968,213,1,12,AL QUSAIS FIRST,القصيص الأولى
1969,213,3,15,AL QUSAIS FIRST,القصيص الأولى
1970,213,3,18,AL QUSAIS FIRST,القصيص الأولى
1971,213,0,18,AL QUSAIS FIRST,القصيص الأولى
1972,213,3,21,AL QUSAIS FIRST,القصيص الأولى
1973,213,4,25,AL QUSAIS FIRST,القصيص الأولى
1974,213,7,32,AL QUSAIS FIRST,القصيص الأولى
1975,213,9,41,AL QUSAIS FIRST,القصيص الأولى
1976,213,0,41,AL QUSAIS FIRST,القصيص الأولى
1977,213,3,44,AL QUSAIS FIRST,القصيص الأولى
1978,213,0,44,AL QUSAIS FIRST,القصيص الأولى
1979,213,6,50,AL QUSAIS FIRST,القصيص الأولى
1980,213,10,60,AL QUSAIS FIRST,القصيص الأولى
1981,213,8,68,AL QUSAIS FIRST,القصيص الأولى
1982,213,12,80,AL QUSAIS FIRST,القصيص الأولى
1983,213,14,94,AL QUSAIS FIRST,القصيص الأولى
1984,213,9,103,AL QUSAIS FIRST,القصيص الأولى
1985,213,8,111,AL QUSAIS FIRST,القصيص الأولى
1986,213,13,124,AL QUSAIS FIRST,القصيص الأولى
1987,213,10,134,AL QUSAIS FIRST,القصيص الأولى
1988,213,14,148,AL QUSAIS FIRST,القصيص الأولى
1989,213,16,164,AL QUSAIS FIRST,القصيص الأولى
1990,213,13,177,AL QUSAIS FIRST,القصيص الأولى
1991,213,12,189,AL QUSAIS FIRST,القصيص الأولى
1992,213,22,211,AL QUSAIS FIRST,القصيص الأولى
1993,213,25,236,AL QUSAIS FIRST,القصيص الأولى
1994,213,25,261,AL QUSAIS FIRST,القصيص الأولى
1995,213,19,280,AL QUSAIS FIRST,القصيص الأولى
1996,213,28,308,AL QUSAIS FIRST,القصيص الأولى
1997,213,25,333,AL QUSAIS FIRST,القصيص الأولى
1998,213,20,353,AL QUSAIS FIRST,القصيص الأولى
1999,213,26,379,AL QUSAIS FIRST,القصيص الأولى
2000,213,38,417,AL QUSAIS FIRST,القصيص الأولى
2001,213,46,463,AL QUSAIS FIRST,القصيص الأولى
2002,213,40,503,AL QUSAIS FIRST,القصيص الأولى
2003,213,56,559,AL QUSAIS FIRST,القصيص الأولى
2004,213,63,622,AL QUSAIS FIRST,القصيص الأولى
2005,213,55,677,AL QUSAIS FIRST,القصيص الأولى
2006,213,65,742,AL QUSAIS FIRST,القصيص الأولى
2007,213,48,790,AL QUSAIS FIRST,القصيص الأولى
2008,213,50,840,AL QUSAIS FIRST,القصيص الأولى
2009,213,33,873,AL QUSAIS FIRST,القصيص الأولى
2010,213,56,929,AL QUSAIS FIRST,القصيص الأولى
2011,213,43,972,AL QUSAIS FIRST,القصيص الأولى
2012,213,60,1032,AL QUSAIS FIRST,القصيص الأولى
2013,213,53,1085,AL QUSAIS FIRST,القصيص الأولى
2014,213,44,1129,AL QUSAIS FIRST,القصيص الأولى
2015,213,44,1173,AL QUSAIS FIRST,القصيص الأولى
2016,213,17,1190,AL QUSAIS FIRST,القصيص الأولى
2017,213,44,1234,AL QUSAIS FIRST,القصيص الأولى
2018,213,36,1270,AL QUSAIS FIRST,القصيص الأولى
2019,213,50,1320,AL QUSAIS FIRST,القصيص الأولى
2020,213,86,1406,AL QUSAIS FIRST,القصيص الأولى
2021,213,0,1406,AL QUSAIS FIRST,القصيص الأولى
1963,253,0,0,OUD AL MUTEENA SECOND,عود المطينة الثانية
1964,253,0,0,OUD AL MUTEENA SECOND,عود المطينة الثانية
1965,253,0,0,OUD AL MUTEENA SECOND,عود المطينة الثانية
1966,253,0,0,OUD AL MUTEENA SECOND,عود المطينة الثانية
1967,253,0,0,OUD AL MUTEENA SECOND,عود المطينة الثانية
1968,253,0,0,OUD AL MUTEENA SECOND,عود المطينة الثانية
1969,253,0,0,OUD AL MUTEENA SECOND,عود المطينة الثانية
1970,253,0,0,OUD AL MUTEENA SECOND,عود المطينة الثانية
1971,253,0,0,OUD AL MUTEENA SECOND,عود المطينة الثانية
1972,253,0,0,OUD AL MUTEENA SECOND,عود المطينة الثانية
1973,253,0,0,OUD AL MUTEENA SECOND,عود المطينة الثانية
1974,253,0,0,OUD AL MUTEENA SECOND,عود المطينة الثانية
1975,253,0,0,OUD AL MUTEENA SECOND,عود المطينة الثانية
1976,253,0,0,OUD AL MUTEENA SECOND,عود المطينة الثانية
1977,253,0,0,OUD AL MUTEENA SECOND,عود المطينة الثانية
1978,253,0,0,OUD AL MUTEENA SECOND,عود المطينة الثانية
1979,253,0,0,OUD AL MUTEENA SECOND,عود المطينة الثانية
1980,253,0,0,OUD AL MUTEENA SECOND,عود المطينة الثانية
1981,253,0,0,OUD AL MUTEENA SECOND,عود المطينة الثانية
1982,253,0,0,OUD AL MUTEENA SECOND,عود المطينة الثانية
1983,253,0,0,OUD AL MUTEENA SECOND,عود المطينة الثانية
1984,253,0,0,OUD AL MUTEENA SECOND,عود المطينة الثانية
1985,253,0,0,OUD AL MUTEENA SECOND,عود المطينة الثانية
1986,253,0,0,OUD AL MUTEENA SECOND,عود المطينة الثانية
1987,253,0,0,OUD AL MUTEENA SECOND,عود المطينة الثانية
1988,253,0,0,OUD AL MUTEENA SECOND,عود المطينة الثانية
1989,253,0,0,OUD AL MUTEENA SECOND,عود المطينة الثانية
1990,253,0,0,OUD AL MUTEENA SECOND,عود المطينة الثانية
1991,253,0,0,OUD AL MUTEENA SECOND,عود المطينة الثانية
1992,253,0,0,OUD AL MUTEENA SECOND,عود المطينة الثانية
1993,253,0,0,OUD AL MUTEENA SECOND,عود المطينة الثانية
1994,253,0,0,OUD AL MUTEENA SECOND,عود المطينة الثانية
1995,253,0,0,OUD AL MUTEENA SECOND,عود المطينة الثانية
1996,253,0,0,OUD AL MUTEENA SECOND,عود المطينة الثانية
1997,253,0,0,OUD AL MUTEENA SECOND,عود المطينة الثانية
1998,253,0,0,OUD AL MUTEENA SECOND,عود المطينة الثانية
1999,253,0,0,OUD AL MUTEENA SECOND,عود المطينة الثانية
2000,253,0,0,OUD AL MUTEENA SECOND,عود المطينة الثانية
2001,253,0,0,OUD AL MUTEENA SECOND,عود المطينة الثانية
2002,253,0,0,OUD AL MUTEENA SECOND,عود المطينة الثانية
2003,253,0,0,OUD AL MUTEENA SECOND,عود المطينة الثانية
2004,253,0,0,OUD AL MUTEENA SECOND,عود المطينة الثانية
2005,253,0,0,OUD AL MUTEENA SECOND,عود المطينة الثانية
2006,253,0,0,OUD AL MUTEENA SECOND,عود المطينة الثانية
2007,253,0,0,OUD AL MUTEENA SECOND,عود المطينة الثانية
2008,253,0,0,OUD AL MUTEENA SECOND,عود المطينة الثانية
2009,253,0,0,OUD AL MUTEENA SECOND,عود المطينة الثانية
2010,253,1,1,OUD AL MUTEENA SECOND,عود المطينة الثانية
2011,253,0,1,OUD AL MUTEENA SECOND,عود المطينة الثانية
2012,253,1,2,OUD AL MUTEENA SECOND,عود المطينة الثانية
2013,253,2,4,OUD AL MUTEENA SECOND,عود المطينة الثانية
2014,253,0,4,OUD AL MUTEENA SECOND,عود المطينة الثانية
2015,253,1,5,OUD AL MUTEENA SECOND,عود المطينة الثانية
2016,253,2,7,OUD AL MUTEENA SECOND,عود المطينة الثانية
2017,253,3,10,OUD AL MUTEENA SECOND,عود المطينة الثانية
2018,253,3,13,OUD AL MUTEENA SECOND,عود المطينة الثانية
2019,253,3,16,OUD AL MUTEENA SECOND,عود المطينة الثانية
2020,253,50,66,OUD AL MUTEENA SECOND,عود المطينة الثانية
2021,253,0,66,OUD AL MUTEENA SECOND,عود المطينة الثانية
1963,293,0,0,AL KHWANEEJ FIRST,الخوانيج الأولى
1964,293,0,0,AL KHWANEEJ FIRST,الخوانيج الأولى
1965,293,0,0,AL KHWANEEJ FIRST,الخوانيج الأولى
1966,293,0,0,AL KHWANEEJ FIRST,الخوانيج الأولى
1967,293,0,0,AL KHWANEEJ FIRST,الخوانيج الأولى
1968,293,0,0,AL KHWANEEJ FIRST,الخوانيج الأولى
1969,293,0,0,AL KHWANEEJ FIRST,الخوانيج الأولى
1970,293,0,0,AL KHWANEEJ FIRST,الخوانيج الأولى
1971,293,0,0,AL KHWANEEJ FIRST,الخوانيج الأولى
1972,293,0,0,AL KHWANEEJ FIRST,الخوانيج الأولى
1973,293,1,1,AL KHWANEEJ FIRST,الخوانيج الأولى
1974,293,0,1,AL KHWANEEJ FIRST,الخوانيج الأولى
1975,293,0,1,AL KHWANEEJ FIRST,الخوانيج الأولى
1976,293,0,1,AL KHWANEEJ FIRST,الخوانيج الأولى
1977,293,0,1,AL KHWANEEJ FIRST,الخوانيج الأولى
1978,293,0,1,AL KHWANEEJ FIRST,الخوانيج الأولى
1979,293,0,1,AL KHWANEEJ FIRST,الخوانيج الأولى
1980,293,0,1,AL KHWANEEJ FIRST,الخوانيج الأولى
1981,293,0,1,AL KHWANEEJ FIRST,الخوانيج الأولى
1982,293,0,1,AL KHWANEEJ FIRST,الخوانيج الأولى
1983,293,0,1,AL KHWANEEJ FIRST,الخوانيج الأولى
1984,293,0,1,AL KHWANEEJ FIRST,الخوانيج الأولى
1985,293,0,1,AL KHWANEEJ FIRST,الخوانيج الأولى
1986,293,0,1,AL KHWANEEJ FIRST,الخوانيج الأولى
1987,293,0,1,AL KHWANEEJ FIRST,الخوانيج الأولى
1988,293,1,2,AL KHWANEEJ FIRST,الخوانيج الأولى
1989,293,1,3,AL KHWANEEJ FIRST,الخوانيج الأولى
1990,293,0,3,AL KHWANEEJ FIRST,الخوانيج الأولى
1991,293,1,4,AL KHWANEEJ FIRST,الخوانيج الأولى
1992,293,0,4,AL KHWANEEJ FIRST,الخوانيج الأولى
1993,293,0,4,AL KHWANEEJ FIRST,الخوانيج الأولى
1994,293,1,5,AL KHWANEEJ FIRST,الخوانيج الأولى
1995,293,3,8,AL KHWANEEJ FIRST,الخوانيج الأولى
1996,293,0,8,AL KHWANEEJ FIRST,الخوانيج الأولى
1997,293,0,8,AL KHWANEEJ FIRST,الخوانيج الأولى
1998,293,1,9,AL KHWANEEJ FIRST,الخوانيج الأولى
1999,293,0,9,AL KHWANEEJ FIRST,الخوانيج الأولى
2000,293,0,9,AL KHWANEEJ FIRST,الخوانيج الأولى
2001,293,3,12,AL KHWANEEJ FIRST,الخوانيج الأولى
2002,293,4,16,AL KHWANEEJ FIRST,الخوانيج الأولى
2003,293,2,18,AL KHWANEEJ FIRST,الخوانيج الأولى
2004,293,1,19,AL KHWANEEJ FIRST,الخوانيج الأولى
2005,293,2,21,AL KHWANEEJ FIRST,الخوانيج الأولى
2006,293,3,24,AL KHWANEEJ FIRST,الخوانيج الأولى
2007,293,3,27,AL KHWANEEJ FIRST,الخوانيج الأولى
2008,293,2,29,AL KHWANEEJ FIRST,الخوانيج الأولى
2009,293,1,30,AL KHWANEEJ FIRST,الخوانيج الأولى
2010,293,3,33,AL KHWANEEJ FIRST,الخوانيج الأولى
2011,293,1,34,AL KHWANEEJ FIRST,الخوانيج الأولى
2012,293,6,40,AL KHWANEEJ FIRST,الخوانيج الأولى
2013,293,2,42,AL KHWANEEJ FIRST,الخوانيج الأولى
2014,293,3,45,AL KHWANEEJ FIRST,الخوانيج الأولى
2015,293,11,56,AL KHWANEEJ FIRST,الخوانيج الأولى
2016,293,17,73,AL KHWANEEJ FIRST,الخوانيج الأولى
2017,293,12,85,AL KHWANEEJ FIRST,الخوانيج الأولى
2018,293,20,105,AL KHWANEEJ FIRST,الخوانيج الأولى
2019,293,30,135,AL KHWANEEJ FIRST,الخوانيج الأولى
2020,293,137,272,AL KHWANEEJ FIRST,الخوانيج الأولى
2021,293,0,272,AL KHWANEEJ FIRST,الخوانيج الأولى
1963,333,7,7,AL SABKHA,السبخة
1964,333,0,7,AL SABKHA,السبخة
1965,333,1,8,AL SABKHA,السبخة
1966,333,3,11,AL SABKHA,السبخة
1967,333,2,13,AL SABKHA,السبخة
1968,333,0,13,AL SABKHA,السبخة
1969,333,2,15,AL SABKHA,السبخة
1970,333,2,17,AL SABKHA,السبخة
1971,333,0,17,AL SABKHA,السبخة
1972,333,0,17,AL SABKHA,السبخة
1973,333,3,20,AL SABKHA,السبخة
1974,333,2,22,AL SABKHA,السبخة
1975,333,2,24,AL SABKHA,السبخة
1976,333,4,28,AL SABKHA,السبخة
1977,333,5,33,AL SABKHA,السبخة
1978,333,1,34,AL SABKHA,السبخة
1979,333,6,40,AL SABKHA,السبخة
1980,333,3,43,AL SABKHA,السبخة
1981,333,6,49,AL SABKHA,السبخة
1982,333,2,51,AL SABKHA,السبخة
1983,333,8,59,AL SABKHA,السبخة
1984,333,4,63,AL SABKHA,السبخة
1985,333,6,69,AL SABKHA,السبخة
1986,333,7,76,AL SABKHA,السبخة
1987,333,2,78,AL SABKHA,السبخة
1988,333,8,86,AL SABKHA,السبخة
1989,333,8,94,AL SABKHA,السبخة
1990,333,8,102,AL SABKHA,السبخة
1991,333,7,109,AL SABKHA,السبخة
1992,333,9,118,AL SABKHA,السبخة
1993,333,5,123,AL SABKHA,السبخة
1994,333,8,131,AL SABKHA,السبخة
1995,333,10,141,AL SABKHA,السبخة
1996,333,7,148,AL SABKHA,السبخة
1997,333,4,152,AL SABKHA,السبخة
1998,333,12,164,AL SABKHA,السبخة
1999,333,10,174,AL SABKHA,السبخة
2000,333,12,186,AL SABKHA,السبخة
2001,333,13,199,AL SABKHA,السبخة
2002,333,19,218,AL SABKHA,السبخة
2003,333,17,235,AL SABKHA,السبخة
2004,333,30,265,AL SABKHA,السبخة
2005,333,22,287,AL SABKHA,السبخة
2006,333,14,301,AL SABKHA,السبخة
2007,333,21,322,AL SABKHA,السبخة
2008,333,23,345,AL SABKHA,السبخة
2009,333,17,362,AL SABKHA,السبخة
2010,333,21,383,AL SABKHA,السبخة
2011,333,21,404,AL SABKHA,السبخة
2012,333,36,440,AL SABKHA,السبخة
2013,333,28,468,AL SABKHA,السبخة
2014,333,16,484,AL SABKHA,السبخة
2015,333,25,509,AL SABKHA,السبخة
2016,333,19,528,AL SABKHA,السبخة
2017,333,21,549,AL SABKHA,السبخة
2018,333,29,578,AL SABKHA,السبخة
2019,333,42,620,AL SABKHA,السبخة
2020,333,49,669,AL SABKHA,السبخة
2021,333,0,669,AL SABKHA,السبخة
1963,413,0,0,AL QOUZ IND.SECOND,القوز الصناعية الثانية
1964,413,0,0,AL QOUZ IND.SECOND,القوز الصناعية الثانية
1965,413,0,0,AL QOUZ IND.SECOND,القوز الصناعية الثانية
1966,413,0,0,AL QOUZ IND.SECOND,القوز الصناعية الثانية
1967,413,0,0,AL QOUZ IND.SECOND,القوز الصناعية الثانية
1968,413,0,0,AL QOUZ IND.SECOND,القوز الصناعية الثانية
1969,413,2,2,AL QOUZ IND.SECOND,القوز الصناعية الثانية
1970,413,0,2,AL QOUZ IND.SECOND,القوز الصناعية الثانية
1971,413,2,4,AL QOUZ IND.SECOND,القوز الصناعية الثانية
1972,413,0,4,AL QOUZ IND.SECOND,القوز الصناعية الثانية
1973,413,1,5,AL QOUZ IND.SECOND,القوز الصناعية الثانية
1974,413,1,6,AL QOUZ IND.SECOND,القوز الصناعية الثانية
1975,413,0,6,AL QOUZ IND.SECOND,القوز الصناعية الثانية
1976,413,0,6,AL QOUZ IND.SECOND,القوز الصناعية الثانية
1977,413,1,7,AL QOUZ IND.SECOND,القوز الصناعية الثانية
1978,413,1,8,AL QOUZ IND.SECOND,القوز الصناعية الثانية
1979,413,1,9,AL QOUZ IND.SECOND,القوز الصناعية الثانية
1980,413,1,10,AL QOUZ IND.SECOND,القوز الصناعية الثانية
1981,413,3,13,AL QOUZ IND.SECOND,القوز الصناعية الثانية
1982,413,5,18,AL QOUZ IND.SECOND,القوز الصناعية الثانية
1983,413,5,23,AL QOUZ IND.SECOND,القوز الصناعية الثانية
1984,413,2,25,AL QOUZ IND.SECOND,القوز الصناعية الثانية
1985,413,0,25,AL QOUZ IND.SECOND,القوز الصناعية الثانية
1986,413,1,26,AL QOUZ IND.SECOND,القوز الصناعية الثانية
1987,413,3,29,AL QOUZ IND.SECOND,القوز الصناعية الثانية
1988,413,2,31,AL QOUZ IND.SECOND,القوز الصناعية الثانية
1989,413,4,35,AL QOUZ IND.SECOND,القوز الصناعية الثانية
1990,413,5,40,AL QOUZ IND.SECOND,القوز الصناعية الثانية
1991,413,2,42,AL QOUZ IND.SECOND,القوز الصناعية الثانية
1992,413,4,46,AL QOUZ IND.SECOND,القوز الصناعية الثانية
1993,413,4,50,AL QOUZ IND.SECOND,القوز الصناعية الثانية
1994,413,8,58,AL QOUZ IND.SECOND,القوز الصناعية الثانية
1995,413,3,61,AL QOUZ IND.SECOND,القوز الصناعية الثانية
1996,413,8,69,AL QOUZ IND.SECOND,القوز الصناعية الثانية
1997,413,12,81,AL QOUZ IND.SECOND,القوز الصناعية الثانية
1998,413,6,87,AL QOUZ IND.SECOND,القوز الصناعية الثانية
1999,413,6,93,AL QOUZ IND.SECOND,القوز الصناعية الثانية
2000,413,12,105,AL QOUZ IND.SECOND,القوز الصناعية الثانية
2001,413,11,116,AL QOUZ IND.SECOND,القوز الصناعية الثانية
2002,413,20,136,AL QOUZ IND.SECOND,القوز الصناعية الثانية
2003,413,14,150,AL QOUZ IND.SECOND,القوز الصناعية الثانية
2004,413,27,177,AL QOUZ IND.SECOND,القوز الصناعية الثانية
2005,413,22,199,AL QOUZ IND.SECOND,القوز الصناعية الثانية
2006,413,23,222,AL QOUZ IND.SECOND,القوز الصناعية الثانية
2007,413,26,248,AL QOUZ IND.SECOND,القوز الصناعية الثانية
2008,413,24,272,AL QOUZ IND.SECOND,القوز الصناعية الثانية
2009,413,16,288,AL QOUZ IND.SECOND,القوز الصناعية الثانية
2010,413,38,326,AL QOUZ IND.SECOND,القوز الصناعية الثانية
2011,413,37,363,AL QOUZ IND.SECOND,القوز الصناعية الثانية
2012,413,48,411,AL QOUZ IND.SECOND,القوز الصناعية الثانية
2013,413,54,465,AL QOUZ IND.SECOND,القوز الصناعية الثانية
2014,413,61,526,AL QOUZ IND.SECOND,القوز الصناعية الثانية
2015,413,69,595,AL QOUZ IND.SECOND,القوز الصناعية الثانية
2016,413,55,650,AL QOUZ IND.SECOND,القوز الصناعية الثانية
2017,413,63,713,AL QOUZ IND.SECOND,القوز الصناعية الثانية
2018,413,66,779,AL QOUZ IND.SECOND,القوز الصناعية الثانية
2019,413,88,867,AL QOUZ IND.SECOND,القوز الصناعية الثانية
2020,413,84,951,AL QOUZ IND.SECOND,القوز الصناعية الثانية
2021,413,0,951,AL QOUZ IND.SECOND,القوز الصناعية الثانية
1963,453,0,0,WADI AL SAFA 7,وادي الصفا 7
1964,453,0,0,WADI AL SAFA 7,وادي الصفا 7
1965,453,0,0,WADI AL SAFA 7,وادي الصفا 7
1966,453,0,0,WADI AL SAFA 7,وادي الصفا 7
1967,453,0,0,WADI AL SAFA 7,وادي الصفا 7
1968,453,0,0,WADI AL SAFA 7,وادي الصفا 7
1969,453,0,0,WADI AL SAFA 7,وادي الصفا 7
1970,453,0,0,WADI AL SAFA 7,وادي الصفا 7
1971,453,0,0,WADI AL SAFA 7,وادي الصفا 7
1972,453,0,0,WADI AL SAFA 7,وادي الصفا 7
1973,453,0,0,WADI AL SAFA 7,وادي الصفا 7
1974,453,0,0,WADI AL SAFA 7,وادي الصفا 7
1975,453,0,0,WADI AL SAFA 7,وادي الصفا 7
1976,453,0,0,WADI AL SAFA 7,وادي الصفا 7
1977,453,0,0,WADI AL SAFA 7,وادي الصفا 7
1978,453,0,0,WADI AL SAFA 7,وادي الصفا 7
1979,453,0,0,WADI AL SAFA 7,وادي الصفا 7
1980,453,0,0,WADI AL SAFA 7,وادي الصفا 7
1981,453,0,0,WADI AL SAFA 7,وادي الصفا 7
1982,453,0,0,WADI AL SAFA 7,وادي الصفا 7
1983,453,0,0,WADI AL SAFA 7,وادي الصفا 7
1984,453,0,0,WADI AL SAFA 7,وادي الصفا 7
1985,453,0,0,WADI AL SAFA 7,وادي الصفا 7
1986,453,0,0,WADI AL SAFA 7,وادي الصفا 7
1987,453,0,0,WADI AL SAFA 7,وادي الصفا 7
1988,453,0,0,WADI AL SAFA 7,وادي الصفا 7
1989,453,0,0,WADI AL SAFA 7,وادي الصفا 7
1990,453,0,0,WADI AL SAFA 7,وادي الصفا 7
1991,453,0,0,WADI AL SAFA 7,وادي الصفا 7
1992,453,0,0,WADI AL SAFA 7,وادي الصفا 7
1993,453,0,0,WADI AL SAFA 7,وادي الصفا 7
1994,453,0,0,WADI AL SAFA 7,وادي الصفا 7
1995,453,0,0,WADI AL SAFA 7,وادي الصفا 7
1996,453,0,0,WADI AL SAFA 7,وادي الصفا 7
1997,453,0,0,WADI AL SAFA 7,وادي الصفا 7
1998,453,0,0,WADI AL SAFA 7,وادي الصفا 7
1999,453,0,0,WADI AL SAFA 7,وادي الصفا 7
2000,453,0,0,WADI AL SAFA 7,وادي الصفا 7
2001,453,0,0,WADI AL SAFA 7,وادي الصفا 7
2002,453,0,0,WADI AL SAFA 7,وادي الصفا 7
2003,453,1,1,WADI AL SAFA 7,وادي الصفا 7
2004,453,1,2,WADI AL SAFA 7,وادي الصفا 7
2005,453,0,2,WADI AL SAFA 7,وادي الصفا 7
2006,453,0,2,WADI AL SAFA 7,وادي الصفا 7
2007,453,0,2,WADI AL SAFA 7,وادي الصفا 7
2008,453,1,3,WADI AL SAFA 7,وادي الصفا 7
2009,453,1,4,WADI AL SAFA 7,وادي الصفا 7
2010,453,1,5,WADI AL SAFA 7,وادي الصفا 7
2011,453,0,5,WADI AL SAFA 7,وادي الصفا 7
2012,453,2,7,WADI AL SAFA 7,وادي الصفا 7
2013,453,0,7,WADI AL SAFA 7,وادي الصفا 7
2014,453,1,8,WADI AL SAFA 7,وادي الصفا 7
2015,453,7,15,WADI AL SAFA 7,وادي الصفا 7
2016,453,6,21,WADI AL SAFA 7,وادي الصفا 7
2017,453,4,25,WADI AL SAFA 7,وادي الصفا 7
2018,453,3,28,WADI AL SAFA 7,وادي الصفا 7
2019,453,9,37,WADI AL SAFA 7,وادي الصفا 7
2020,453,18,55,WADI AL SAFA 7,وادي الصفا 7
2021,453,0,55,WADI AL SAFA 7,وادي الصفا 7
1963,493,0,0,UMM RAMOOL,أم رمول
1964,493,1,1,UMM RAMOOL,أم رمول
1965,493,0,1,UMM RAMOOL,أم رمول
1966,493,1,2,UMM RAMOOL,أم رمول
1967,493,1,3,UMM RAMOOL,أم رمول
1968,493,0,3,UMM RAMOOL,أم رمول
1969,493,0,3,UMM RAMOOL,أم رمول
1970,493,1,4,UMM RAMOOL,أم رمول
1971,493,1,5,UMM RAMOOL,أم رمول
1972,493,3,8,UMM RAMOOL,أم رمول
1973,493,4,12,UMM RAMOOL,أم رمول
1974,493,5,17,UMM RAMOOL,أم رمول
1975,493,4,21,UMM RAMOOL,أم رمول
1976,493,5,26,UMM RAMOOL,أم رمول
1977,493,6,32,UMM RAMOOL,أم رمول
1978,493,7,39,UMM RAMOOL,أم رمول
1979,493,3,42,UMM RAMOOL,أم رمول
1980,493,10,52,UMM RAMOOL,أم رمول
1981,493,8,60,UMM RAMOOL,أم رمول
1982,493,2,62,UMM RAMOOL,أم رمول
1983,493,6,68,UMM RAMOOL,أم رمول
1984,493,3,71,UMM RAMOOL,أم رمول
1985,493,4,75,UMM RAMOOL,أم رمول
1986,493,7,82,UMM RAMOOL,أم رمول
1987,493,2,84,UMM RAMOOL,أم رمول
1988,493,4,88,UMM RAMOOL,أم رمول
1989,493,7,95,UMM RAMOOL,أم رمول
1990,493,9,104,UMM RAMOOL,أم رمول
1991,493,7,111,UMM RAMOOL,أم رمول
1992,493,5,116,UMM RAMOOL,أم رمول
1993,493,6,122,UMM RAMOOL,أم رمول
1994,493,11,133,UMM RAMOOL,أم رمول
1995,493,8,141,UMM RAMOOL,أم رمول
1996,493,12,153,UMM RAMOOL,أم رمول
1997,493,7,160,UMM RAMOOL,أم رمول
1998,493,13,173,UMM RAMOOL,أم رمول
1999,493,12,185,UMM RAMOOL,أم رمول
2000,493,9,194,UMM RAMOOL,أم رمول
2001,493,25,219,UMM RAMOOL,أم رمول
2002,493,23,242,UMM RAMOOL,أم رمول
2003,493,22,264,UMM RAMOOL,أم رمول
2004,493,29,293,UMM RAMOOL,أم رمول
2005,493,28,321,UMM RAMOOL,أم رمول
2006,493,26,347,UMM RAMOOL,أم رمول
2007,493,24,371,UMM RAMOOL,أم رمول
2008,493,32,403,UMM RAMOOL,أم رمول
2009,493,23,426,UMM RAMOOL,أم رمول
2010,493,32,458,UMM RAMOOL,أم رمول
2011,493,47,505,UMM RAMOOL,أم رمول
2012,493,47,552,UMM RAMOOL,أم رمول
2013,493,53,605,UMM RAMOOL,أم رمول
2014,493,59,664,UMM RAMOOL,أم رمول
2015,493,66,730,UMM RAMOOL,أم رمول
2016,493,71,801,UMM RAMOOL,أم رمول
2017,493,75,876,UMM RAMOOL,أم رمول
2018,493,90,966,UMM RAMOOL,أم رمول
2019,493,214,1180,UMM RAMOOL,أم رمول
2020,493,505,1685,UMM RAMOOL,أم رمول
2021,493,0,1685,UMM RAMOOL,أم رمول
1963,533,0,0,"AL WARQA'A FOURTH",الورقاء الرابعة
1964,533,0,0,"AL WARQA'A FOURTH",الورقاء الرابعة
1965,533,0,0,"AL WARQA'A FOURTH",الورقاء الرابعة
1966,533,0,0,"AL WARQA'A FOURTH",الورقاء الرابعة
1967,533,0,0,"AL WARQA'A FOURTH",الورقاء الرابعة
1968,533,0,0,"AL WARQA'A FOURTH",الورقاء الرابعة
1969,533,0,0,"AL WARQA'A FOURTH",الورقاء الرابعة
1970,533,0,0,"AL WARQA'A FOURTH",الورقاء الرابعة
1971,533,0,0,"AL WARQA'A FOURTH",الورقاء الرابعة
1972,533,0,0,"AL WARQA'A FOURTH",الورقاء الرابعة
1973,533,0,0,"AL WARQA'A FOURTH",الورقاء الرابعة
1974,533,0,0,"AL WARQA'A FOURTH",الورقاء الرابعة
1975,533,0,0,"AL WARQA'A FOURTH",الورقاء الرابعة
1976,533,0,0,"AL WARQA'A FOURTH",الورقاء الرابعة
1977,533,0,0,"AL WARQA'A FOURTH",الورقاء الرابعة
1978,533,0,0,"AL WARQA'A FOURTH",الورقاء الرابعة
1979,533,0,0,"AL WARQA'A FOURTH",الورقاء الرابعة
1980,533,0,0,"AL WARQA'A FOURTH",الورقاء الرابعة
1981,533,0,0,"AL WARQA'A FOURTH",الورقاء الرابعة
1982,533,0,0,"AL WARQA'A FOURTH",الورقاء الرابعة
1983,533,0,0,"AL WARQA'A FOURTH",الورقاء الرابعة
1984,533,0,0,"AL WARQA'A FOURTH",الورقاء الرابعة
1985,533,0,0,"AL WARQA'A FOURTH",الورقاء الرابعة
1986,533,0,0,"AL WARQA'A FOURTH",الورقاء الرابعة
1987,533,0,0,"AL WARQA'A FOURTH",الورقاء الرابعة
1988,533,0,0,"AL WARQA'A FOURTH",الورقاء الرابعة
1989,533,0,0,"AL WARQA'A FOURTH",الورقاء الرابعة
1990,533,0,0,"AL WARQA'A FOURTH",الورقاء الرابعة
1991,533,0,0,"AL WARQA'A FOURTH",الورقاء الرابعة
1992,533,0,0,"AL WARQA'A FOURTH",الورقاء الرابعة
1993,533,0,0,"AL WARQA'A FOURTH",الورقاء الرابعة
1994,533,0,0,"AL WARQA'A FOURTH",الورقاء الرابعة
1995,533,0,0,"AL WARQA'A FOURTH",الورقاء الرابعة
1996,533,0,0,"AL WARQA'A FOURTH",الورقاء الرابعة
1997,533,0,0,"AL WARQA'A FOURTH",الورقاء الرابعة
1998,533,0,0,"AL WARQA'A FOURTH",الورقاء الرابعة
1999,533,0,0,"AL WARQA'A FOURTH",الورقاء الرابعة
2000,533,0,0,"AL WARQA'A FOURTH",الورقاء الرابعة
2001,533,0,0,"AL WARQA'A FOURTH",الورقاء الرابعة
2002,533,0,0,"AL WARQA'A FOURTH",الورقاء الرابعة
2003,533,0,0,"AL WARQA'A FOURTH",الورقاء الرابعة
2004,533,1,1,"AL WARQA'A FOURTH",الورقاء الرابعة
2005,533,0,1,"AL WARQA'A FOURTH",الورقاء الرابعة
2006,533,0,1,"AL WARQA'A FOURTH",الورقاء الرابعة
2007,533,0,1,"AL WARQA'A FOURTH",الورقاء الرابعة
2008,533,1,2,"AL WARQA'A FOURTH",الورقاء الرابعة
2009,533,1,3,"AL WARQA'A FOURTH",الورقاء الرابعة
2010,533,1,4,"AL WARQA'A FOURTH",الورقاء الرابعة
2011,533,0,4,"AL WARQA'A FOURTH",الورقاء الرابعة
2012,533,1,5,"AL WARQA'A FOURTH",الورقاء الرابعة
2013,533,4,9,"AL WARQA'A FOURTH",الورقاء الرابعة
2014,533,3,12,"AL WARQA'A FOURTH",الورقاء الرابعة
2015,533,4,16,"AL WARQA'A FOURTH",الورقاء الرابعة
2016,533,5,21,"AL WARQA'A FOURTH",الورقاء الرابعة
2017,533,15,36,"AL WARQA'A FOURTH",الورقاء الرابعة
2018,533,9,45,"AL WARQA'A FOURTH",الورقاء الرابعة
2019,533,8,53,"AL WARQA'A FOURTH",الورقاء الرابعة
2020,533,62,115,"AL WARQA'A FOURTH",الورقاء الرابعة
2021,533,0,115,"AL WARQA'A FOURTH",الورقاء الرابعة
1963,573,20,20,RIGGAT AL BUTEEN,رقة البطين
1964,573,1,21,RIGGAT AL BUTEEN,رقة البطين
1965,573,6,27,RIGGAT AL BUTEEN,رقة البطين
1966,573,3,30,RIGGAT AL BUTEEN,رقة البطين
1967,573,6,36,RIGGAT AL BUTEEN,رقة البطين
1968,573,1,37,RIGGAT AL BUTEEN,رقة البطين
1969,573,2,39,RIGGAT AL BUTEEN,رقة البطين
1970,573,3,42,RIGGAT AL BUTEEN,رقة البطين
1971,573,5,47,RIGGAT AL BUTEEN,رقة البطين
1972,573,1,48,RIGGAT AL BUTEEN,رقة البطين
1973,573,6,54,RIGGAT AL BUTEEN,رقة البطين
1974,573,5,59,RIGGAT AL BUTEEN,رقة البطين
1975,573,8,67,RIGGAT AL BUTEEN,رقة البطين
1976,573,4,71,RIGGAT AL BUTEEN,رقة البطين
1977,573,8,79,RIGGAT AL BUTEEN,رقة البطين
1978,573,13,92,RIGGAT AL BUTEEN,رقة البطين
1979,573,8,100,RIGGAT AL BUTEEN,رقة البطين
1980,573,21,121,RIGGAT AL BUTEEN,رقة البطين
1981,573,20,141,RIGGAT AL BUTEEN,رقة البطين
1982,573,16,157,RIGGAT AL BUTEEN,رقة البطين
1983,573,9,166,RIGGAT AL BUTEEN,رقة البطين
1984,573,8,174,RIGGAT AL BUTEEN,رقة البطين
1985,573,10,184,RIGGAT AL BUTEEN,رقة البطين
1986,573,19,203,RIGGAT AL BUTEEN,رقة البطين
1987,573,13,216,RIGGAT AL BUTEEN,رقة البطين
1988,573,19,235,RIGGAT AL BUTEEN,رقة البطين
1989,573,22,257,RIGGAT AL BUTEEN,رقة البطين
1990,573,14,271,RIGGAT AL BUTEEN,رقة البطين
1991,573,27,298,RIGGAT AL BUTEEN,رقة البطين
1992,573,13,311,RIGGAT AL BUTEEN,رقة البطين
1993,573,23,334,RIGGAT AL BUTEEN,رقة البطين
1994,573,21,355,RIGGAT AL BUTEEN,رقة البطين
1995,573,34,389,RIGGAT AL BUTEEN,رقة البطين
1996,573,42,431,RIGGAT AL BUTEEN,رقة البطين
1997,573,47,478,RIGGAT AL BUTEEN,رقة البطين
1998,573,26,504,RIGGAT AL BUTEEN,رقة البطين
1999,573,24,528,RIGGAT AL BUTEEN,رقة البطين
2000,573,42,570,RIGGAT AL BUTEEN,رقة البطين
2001,573,65,635,RIGGAT AL BUTEEN,رقة البطين
2002,573,84,719,RIGGAT AL BUTEEN,رقة البطين
2003,573,76,795,RIGGAT AL BUTEEN,رقة البطين
2004,573,63,858,RIGGAT AL BUTEEN,رقة البطين
2005,573,57,915,RIGGAT AL BUTEEN,رقة البطين
2006,573,80,995,RIGGAT AL BUTEEN,رقة البطين
2007,573,68,1063,RIGGAT AL BUTEEN,رقة البطين
2008,573,57,1120,RIGGAT AL BUTEEN,رقة البطين
2009,573,46,1166,RIGGAT AL BUTEEN,رقة البطين
2010,573,74,1240,RIGGAT AL BUTEEN,رقة البطين
2011,573,83,1323,RIGGAT AL BUTEEN,رقة البطين
2012,573,94,1417,RIGGAT AL BUTEEN,رقة البطين
2013,573,92,1509,RIGGAT AL BUTEEN,رقة البطين
2014,573,98,1607,RIGGAT AL BUTEEN,رقة البطين
2015,573,123,1730,RIGGAT AL BUTEEN,رقة البطين
2016,573,101,1831,RIGGAT AL BUTEEN,رقة البطين
2017,573,101,1932,RIGGAT AL BUTEEN,رقة البطين
2018,573,119,2051,RIGGAT AL BUTEEN,رقة البطين
2019,573,215,2266,RIGGAT AL BUTEEN,رقة البطين
2020,573,260,2526,RIGGAT AL BUTEEN,رقة البطين
2021,573,0,2526,RIGGAT AL BUTEEN,رقة البطين
,733,0,0,,البدع
1963,813,0,0,AL KHWANEEJ SECOND,الخوانيج الثانية
1964,813,0,0,AL KHWANEEJ SECOND,الخوانيج الثانية
1965,813,0,0,AL KHWANEEJ SECOND,الخوانيج الثانية
1966,813,0,0,AL KHWANEEJ SECOND,الخوانيج الثانية
1967,813,0,0,AL KHWANEEJ SECOND,الخوانيج الثانية
1968,813,0,0,AL KHWANEEJ SECOND,الخوانيج الثانية
1969,813,0,0,AL KHWANEEJ SECOND,الخوانيج الثانية
1970,813,0,0,AL KHWANEEJ SECOND,الخوانيج الثانية
1971,813,0,0,AL KHWANEEJ SECOND,الخوانيج الثانية
1972,813,0,0,AL KHWANEEJ SECOND,الخوانيج الثانية
1973,813,0,0,AL KHWANEEJ SECOND,الخوانيج الثانية
1974,813,0,0,AL KHWANEEJ SECOND,الخوانيج الثانية
1975,813,0,0,AL KHWANEEJ SECOND,الخوانيج الثانية
1976,813,0,0,AL KHWANEEJ SECOND,الخوانيج الثانية
1977,813,0,0,AL KHWANEEJ SECOND,الخوانيج الثانية
1978,813,0,0,AL KHWANEEJ SECOND,الخوانيج الثانية
1979,813,1,1,AL KHWANEEJ SECOND,الخوانيج الثانية
1980,813,0,1,AL KHWANEEJ SECOND,الخوانيج الثانية
1981,813,0,1,AL KHWANEEJ SECOND,الخوانيج الثانية
1982,813,0,1,AL KHWANEEJ SECOND,الخوانيج الثانية
1983,813,0,1,AL KHWANEEJ SECOND,الخوانيج الثانية
1984,813,0,1,AL KHWANEEJ SECOND,الخوانيج الثانية
1985,813,0,1,AL KHWANEEJ SECOND,الخوانيج الثانية
1986,813,1,2,AL KHWANEEJ SECOND,الخوانيج الثانية
1987,813,1,3,AL KHWANEEJ SECOND,الخوانيج الثانية
1988,813,1,4,AL KHWANEEJ SECOND,الخوانيج الثانية
1989,813,0,4,AL KHWANEEJ SECOND,الخوانيج الثانية
1990,813,0,4,AL KHWANEEJ SECOND,الخوانيج الثانية
1991,813,0,4,AL KHWANEEJ SECOND,الخوانيج الثانية
1992,813,0,4,AL KHWANEEJ SECOND,الخوانيج الثانية
1993,813,0,4,AL KHWANEEJ SECOND,الخوانيج الثانية
1994,813,1,5,AL KHWANEEJ SECOND,الخوانيج الثانية
1995,813,0,5,AL KHWANEEJ SECOND,الخوانيج الثانية
1996,813,0,5,AL KHWANEEJ SECOND,الخوانيج الثانية
1997,813,0,5,AL KHWANEEJ SECOND,الخوانيج الثانية
1998,813,0,5,AL KHWANEEJ SECOND,الخوانيج الثانية
1999,813,0,5,AL KHWANEEJ SECOND,الخوانيج الثانية
2000,813,0,5,AL KHWANEEJ SECOND,الخوانيج الثانية
2001,813,2,7,AL KHWANEEJ SECOND,الخوانيج الثانية
2002,813,3,10,AL KHWANEEJ SECOND,الخوانيج الثانية
2003,813,3,13,AL KHWANEEJ SECOND,الخوانيج الثانية
2004,813,0,13,AL KHWANEEJ SECOND,الخوانيج الثانية
2005,813,0,13,AL KHWANEEJ SECOND,الخوانيج الثانية
2006,813,0,13,AL KHWANEEJ SECOND,الخوانيج الثانية
2007,813,0,13,AL KHWANEEJ SECOND,الخوانيج الثانية
2008,813,1,14,AL KHWANEEJ SECOND,الخوانيج الثانية
2009,813,0,14,AL KHWANEEJ SECOND,الخوانيج الثانية
2010,813,0,14,AL KHWANEEJ SECOND,الخوانيج الثانية
2011,813,1,15,AL KHWANEEJ SECOND,الخوانيج الثانية
2012,813,0,15,AL KHWANEEJ SECOND,الخوانيج الثانية
2013,813,1,16,AL KHWANEEJ SECOND,الخوانيج الثانية
2014,813,2,18,AL KHWANEEJ SECOND,الخوانيج الثانية
2015,813,3,21,AL KHWANEEJ SECOND,الخوانيج الثانية
2016,813,3,24,AL KHWANEEJ SECOND,الخوانيج الثانية
2017,813,10,34,AL KHWANEEJ SECOND,الخوانيج الثانية
2018,813,6,40,AL KHWANEEJ SECOND,الخوانيج الثانية
2019,813,5,45,AL KHWANEEJ SECOND,الخوانيج الثانية
2020,813,28,73,AL KHWANEEJ SECOND,الخوانيج الثانية
2021,813,0,73,AL KHWANEEJ SECOND,الخوانيج الثانية
1963,853,0,0,UMM NAHAD FOURTH,أم نهد الرابعة
1964,853,0,0,UMM NAHAD FOURTH,أم نهد الرابعة
1965,853,0,0,UMM NAHAD FOURTH,أم نهد الرابعة
1966,853,0,0,UMM NAHAD FOURTH,أم نهد الرابعة
1967,853,0,0,UMM NAHAD FOURTH,أم نهد الرابعة
1968,853,0,0,UMM NAHAD FOURTH,أم نهد الرابعة
1969,853,0,0,UMM NAHAD FOURTH,أم نهد الرابعة
1970,853,0,0,UMM NAHAD FOURTH,أم نهد الرابعة
1971,853,0,0,UMM NAHAD FOURTH,أم نهد الرابعة
1972,853,0,0,UMM NAHAD FOURTH,أم نهد الرابعة
1973,853,0,0,UMM NAHAD FOURTH,أم نهد الرابعة
1974,853,0,0,UMM NAHAD FOURTH,أم نهد الرابعة
1975,853,0,0,UMM NAHAD FOURTH,أم نهد الرابعة
1976,853,0,0,UMM NAHAD FOURTH,أم نهد الرابعة
1977,853,0,0,UMM NAHAD FOURTH,أم نهد الرابعة
1978,853,0,0,UMM NAHAD FOURTH,أم نهد الرابعة
1979,853,0,0,UMM NAHAD FOURTH,أم نهد الرابعة
1980,853,0,0,UMM NAHAD FOURTH,أم نهد الرابعة
1981,853,0,0,UMM NAHAD FOURTH,أم نهد الرابعة
1982,853,0,0,UMM NAHAD FOURTH,أم نهد الرابعة
1983,853,0,0,UMM NAHAD FOURTH,أم نهد الرابعة
1984,853,0,0,UMM NAHAD FOURTH,أم نهد الرابعة
1985,853,0,0,UMM NAHAD FOURTH,أم نهد الرابعة
1986,853,0,0,UMM NAHAD FOURTH,أم نهد الرابعة
1987,853,0,0,UMM NAHAD FOURTH,أم نهد الرابعة
1988,853,0,0,UMM NAHAD FOURTH,أم نهد الرابعة
1989,853,0,0,UMM NAHAD FOURTH,أم نهد الرابعة
1990,853,0,0,UMM NAHAD FOURTH,أم نهد الرابعة
1991,853,0,0,UMM NAHAD FOURTH,أم نهد الرابعة
1992,853,0,0,UMM NAHAD FOURTH,أم نهد الرابعة
1993,853,0,0,UMM NAHAD FOURTH,أم نهد الرابعة
1994,853,0,0,UMM NAHAD FOURTH,أم نهد الرابعة
1995,853,0,0,UMM NAHAD FOURTH,أم نهد الرابعة
1996,853,0,0,UMM NAHAD FOURTH,أم نهد الرابعة
1997,853,0,0,UMM NAHAD FOURTH,أم نهد الرابعة
1998,853,0,0,UMM NAHAD FOURTH,أم نهد الرابعة
1999,853,0,0,UMM NAHAD FOURTH,أم نهد الرابعة
2000,853,0,0,UMM NAHAD FOURTH,أم نهد الرابعة
2001,853,0,0,UMM NAHAD FOURTH,أم نهد الرابعة
2002,853,0,0,UMM NAHAD FOURTH,أم نهد الرابعة
2003,853,0,0,UMM NAHAD FOURTH,أم نهد الرابعة
2004,853,0,0,UMM NAHAD FOURTH,أم نهد الرابعة
2005,853,0,0,UMM NAHAD FOURTH,أم نهد الرابعة
2006,853,0,0,UMM NAHAD FOURTH,أم نهد الرابعة
2007,853,1,1,UMM NAHAD FOURTH,أم نهد الرابعة
2008,853,0,1,UMM NAHAD FOURTH,أم نهد الرابعة
2009,853,0,1,UMM NAHAD FOURTH,أم نهد الرابعة
2010,853,0,1,UMM NAHAD FOURTH,أم نهد الرابعة
2011,853,0,1,UMM NAHAD FOURTH,أم نهد الرابعة
2012,853,0,1,UMM NAHAD FOURTH,أم نهد الرابعة
2013,853,0,1,UMM NAHAD FOURTH,أم نهد الرابعة
2014,853,0,1,UMM NAHAD FOURTH,أم نهد الرابعة
2015,853,0,1,UMM NAHAD FOURTH,أم نهد الرابعة
2016,853,0,1,UMM NAHAD FOURTH,أم نهد الرابعة
2017,853,0,1,UMM NAHAD FOURTH,أم نهد الرابعة
2018,853,1,2,UMM NAHAD FOURTH,أم نهد الرابعة
2019,853,0,2,UMM NAHAD FOURTH,أم نهد الرابعة
2020,853,0,2,UMM NAHAD FOURTH,أم نهد الرابعة
2021,853,0,2,UMM NAHAD FOURTH,أم نهد الرابعة
1963,933,3,3,AL BARSHA FIRST,البرشاء الأولى
1964,933,0,3,AL BARSHA FIRST,البرشاء الأولى
1965,933,0,3,AL BARSHA FIRST,البرشاء الأولى
1966,933,0,3,AL BARSHA FIRST,البرشاء الأولى
1967,933,0,3,AL BARSHA FIRST,البرشاء الأولى
1968,933,0,3,AL BARSHA FIRST,البرشاء الأولى
1969,933,1,4,AL BARSHA FIRST,البرشاء الأولى
1970,933,0,4,AL BARSHA FIRST,البرشاء الأولى
1971,933,2,6,AL BARSHA FIRST,البرشاء الأولى
1972,933,1,7,AL BARSHA FIRST,البرشاء الأولى
1973,933,1,8,AL BARSHA FIRST,البرشاء الأولى
1974,933,2,10,AL BARSHA FIRST,البرشاء الأولى
1975,933,3,13,AL BARSHA FIRST,البرشاء الأولى
1976,933,1,14,AL BARSHA FIRST,البرشاء الأولى
1977,933,1,15,AL BARSHA FIRST,البرشاء الأولى
1978,933,2,17,AL BARSHA FIRST,البرشاء الأولى
1979,933,0,17,AL BARSHA FIRST,البرشاء الأولى
1980,933,2,19,AL BARSHA FIRST,البرشاء الأولى
1981,933,3,22,AL BARSHA FIRST,البرشاء الأولى
1982,933,2,24,AL BARSHA FIRST,البرشاء الأولى
1983,933,2,26,AL BARSHA FIRST,البرشاء الأولى
1984,933,3,29,AL BARSHA FIRST,البرشاء الأولى
1985,933,3,32,AL BARSHA FIRST,البرشاء الأولى
1986,933,2,34,AL BARSHA FIRST,البرشاء الأولى
1987,933,2,36,AL BARSHA FIRST,البرشاء الأولى
1988,933,6,42,AL BARSHA FIRST,البرشاء الأولى
1989,933,2,44,AL BARSHA FIRST,البرشاء الأولى
1990,933,8,52,AL BARSHA FIRST,البرشاء الأولى
1991,933,4,56,AL BARSHA FIRST,البرشاء الأولى
1992,933,5,61,AL BARSHA FIRST,البرشاء الأولى
1993,933,5,66,AL BARSHA FIRST,البرشاء الأولى
1994,933,8,74,AL BARSHA FIRST,البرشاء الأولى
1995,933,7,81,AL BARSHA FIRST,البرشاء الأولى
1996,933,8,89,AL BARSHA FIRST,البرشاء الأولى
1997,933,14,103,AL BARSHA FIRST,البرشاء الأولى
1998,933,7,110,AL BARSHA FIRST,البرشاء الأولى
1999,933,10,120,AL BARSHA FIRST,البرشاء الأولى
2000,933,14,134,AL BARSHA FIRST,البرشاء الأولى
2001,933,16,150,AL BARSHA FIRST,البرشاء الأولى
2002,933,24,174,AL BARSHA FIRST,البرشاء الأولى
2003,933,27,201,AL BARSHA FIRST,البرشاء الأولى
2004,933,33,234,AL BARSHA FIRST,البرشاء الأولى
2005,933,127,361,AL BARSHA FIRST,البرشاء الأولى
2006,933,37,398,AL BARSHA FIRST,البرشاء الأولى
2007,933,65,463,AL BARSHA FIRST,البرشاء الأولى
2008,933,80,543,AL BARSHA FIRST,البرشاء الأولى
2009,933,57,600,AL BARSHA FIRST,البرشاء الأولى
2010,933,80,680,AL BARSHA FIRST,البرشاء الأولى
2011,933,73,753,AL BARSHA FIRST,البرشاء الأولى
2012,933,96,849,AL BARSHA FIRST,البرشاء الأولى
2013,933,107,956,AL BARSHA FIRST,البرشاء الأولى
2014,933,111,1067,AL BARSHA FIRST,البرشاء الأولى
2015,933,124,1191,AL BARSHA FIRST,البرشاء الأولى
2016,933,144,1335,AL BARSHA FIRST,البرشاء الأولى
2017,933,156,1491,AL BARSHA FIRST,البرشاء الأولى
2018,933,166,1657,AL BARSHA FIRST,البرشاء الأولى
2019,933,429,2086,AL BARSHA FIRST,البرشاء الأولى
2020,933,416,2502,AL BARSHA FIRST,البرشاء الأولى
2021,933,0,2502,AL BARSHA FIRST,البرشاء الأولى
1963,973,0,0,AL SAFA FIRST,الصفا الأولى
1964,973,0,0,AL SAFA FIRST,الصفا الأولى
1965,973,0,0,AL SAFA FIRST,الصفا الأولى
1966,973,0,0,AL SAFA FIRST,الصفا الأولى
1967,973,0,0,AL SAFA FIRST,الصفا الأولى
1968,973,0,0,AL SAFA FIRST,الصفا الأولى
1969,973,0,0,AL SAFA FIRST,الصفا الأولى
1970,973,0,0,AL SAFA FIRST,الصفا الأولى
1971,973,0,0,AL SAFA FIRST,الصفا الأولى
1972,973,0,0,AL SAFA FIRST,الصفا الأولى
1973,973,0,0,AL SAFA FIRST,الصفا الأولى
1974,973,1,1,AL SAFA FIRST,الصفا الأولى
1975,973,0,1,AL SAFA FIRST,الصفا الأولى
1976,973,0,1,AL SAFA FIRST,الصفا الأولى
1977,973,0,1,AL SAFA FIRST,الصفا الأولى
1978,973,1,2,AL SAFA FIRST,الصفا الأولى
1979,973,0,2,AL SAFA FIRST,الصفا الأولى
1980,973,3,5,AL SAFA FIRST,الصفا الأولى
1981,973,1,6,AL SAFA FIRST,الصفا الأولى
1982,973,1,7,AL SAFA FIRST,الصفا الأولى
1983,973,0,7,AL SAFA FIRST,الصفا الأولى
1984,973,0,7,AL SAFA FIRST,الصفا الأولى
1985,973,0,7,AL SAFA FIRST,الصفا الأولى
1986,973,0,7,AL SAFA FIRST,الصفا الأولى
1987,973,0,7,AL SAFA FIRST,الصفا الأولى
1988,973,1,8,AL SAFA FIRST,الصفا الأولى
1989,973,2,10,AL SAFA FIRST,الصفا الأولى
1990,973,4,14,AL SAFA FIRST,الصفا الأولى
1991,973,1,15,AL SAFA FIRST,الصفا الأولى
1992,973,2,17,AL SAFA FIRST,الصفا الأولى
1993,973,0,17,AL SAFA FIRST,الصفا الأولى
1994,973,1,18,AL SAFA FIRST,الصفا الأولى
1995,973,1,19,AL SAFA FIRST,الصفا الأولى
1996,973,2,21,AL SAFA FIRST,الصفا الأولى
1997,973,1,22,AL SAFA FIRST,الصفا الأولى
1998,973,2,24,AL SAFA FIRST,الصفا الأولى
1999,973,4,28,AL SAFA FIRST,الصفا الأولى
2000,973,3,31,AL SAFA FIRST,الصفا الأولى
2001,973,4,35,AL SAFA FIRST,الصفا الأولى
2002,973,3,38,AL SAFA FIRST,الصفا الأولى
2003,973,4,42,AL SAFA FIRST,الصفا الأولى
2004,973,3,45,AL SAFA FIRST,الصفا الأولى
2005,973,5,50,AL SAFA FIRST,الصفا الأولى
2006,973,5,55,AL SAFA FIRST,الصفا الأولى
2007,973,7,62,AL SAFA FIRST,الصفا الأولى
2008,973,5,67,AL SAFA FIRST,الصفا الأولى
2009,973,9,76,AL SAFA FIRST,الصفا الأولى
2010,973,11,87,AL SAFA FIRST,الصفا الأولى
2011,973,14,101,AL SAFA FIRST,الصفا الأولى
2012,973,22,123,AL SAFA FIRST,الصفا الأولى
2013,973,10,133,AL SAFA FIRST,الصفا الأولى
2014,973,7,140,AL SAFA FIRST,الصفا الأولى
2015,973,14,154,AL SAFA FIRST,الصفا الأولى
2016,973,10,164,AL SAFA FIRST,الصفا الأولى
2017,973,18,182,AL SAFA FIRST,الصفا الأولى
2018,973,18,200,AL SAFA FIRST,الصفا الأولى
2019,973,33,233,AL SAFA FIRST,الصفا الأولى
2020,973,56,289,AL SAFA FIRST,الصفا الأولى
2021,973,0,289,AL SAFA FIRST,الصفا الأولى
1963,1053,3,3,AL RASHIDIYA,الراشدية
1964,1053,2,5,AL RASHIDIYA,الراشدية
1965,1053,1,6,AL RASHIDIYA,الراشدية
1966,1053,0,6,AL RASHIDIYA,الراشدية
1967,1053,0,6,AL RASHIDIYA,الراشدية
1968,1053,0,6,AL RASHIDIYA,الراشدية
1969,1053,0,6,AL RASHIDIYA,الراشدية
1970,1053,0,6,AL RASHIDIYA,الراشدية
1971,1053,2,8,AL RASHIDIYA,الراشدية
1972,1053,1,9,AL RASHIDIYA,الراشدية
1973,1053,1,10,AL RASHIDIYA,الراشدية
1974,1053,0,10,AL RASHIDIYA,الراشدية
1975,1053,3,13,AL RASHIDIYA,الراشدية
1976,1053,4,17,AL RASHIDIYA,الراشدية
1977,1053,3,20,AL RASHIDIYA,الراشدية
1978,1053,4,24,AL RASHIDIYA,الراشدية
1979,1053,4,28,AL RASHIDIYA,الراشدية
1980,1053,11,39,AL RASHIDIYA,الراشدية
1981,1053,2,41,AL RASHIDIYA,الراشدية
1982,1053,6,47,AL RASHIDIYA,الراشدية
1983,1053,6,53,AL RASHIDIYA,الراشدية
1984,1053,7,60,AL RASHIDIYA,الراشدية
1985,1053,4,64,AL RASHIDIYA,الراشدية
1986,1053,7,71,AL RASHIDIYA,الراشدية
1987,1053,4,75,AL RASHIDIYA,الراشدية
1988,1053,5,80,AL RASHIDIYA,الراشدية
1989,1053,5,85,AL RASHIDIYA,الراشدية
1990,1053,8,93,AL RASHIDIYA,الراشدية
1991,1053,4,97,AL RASHIDIYA,الراشدية
1992,1053,8,105,AL RASHIDIYA,الراشدية
1993,1053,7,112,AL RASHIDIYA,الراشدية
1994,1053,9,121,AL RASHIDIYA,الراشدية
1995,1053,2,123,AL RASHIDIYA,الراشدية
1996,1053,3,126,AL RASHIDIYA,الراشدية
1997,1053,4,130,AL RASHIDIYA,الراشدية
1998,1053,5,135,AL RASHIDIYA,الراشدية
1999,1053,4,139,AL RASHIDIYA,الراشدية
2000,1053,13,152,AL RASHIDIYA,الراشدية
2001,1053,16,168,AL RASHIDIYA,الراشدية
2002,1053,8,176,AL RASHIDIYA,الراشدية
2003,1053,10,186,AL RASHIDIYA,الراشدية
2004,1053,12,198,AL RASHIDIYA,الراشدية
2005,1053,12,210,AL RASHIDIYA,الراشدية
2006,1053,17,227,AL RASHIDIYA,الراشدية
2007,1053,5,232,AL RASHIDIYA,الراشدية
2008,1053,7,239,AL RASHIDIYA,الراشدية
2009,1053,8,247,AL RASHIDIYA,الراشدية
2010,1053,13,260,AL RASHIDIYA,الراشدية
2011,1053,13,273,AL RASHIDIYA,الراشدية
2012,1053,15,288,AL RASHIDIYA,الراشدية
2013,1053,14,302,AL RASHIDIYA,الراشدية
2014,1053,16,318,AL RASHIDIYA,الراشدية
2015,1053,11,329,AL RASHIDIYA,الراشدية
2016,1053,18,347,AL RASHIDIYA,الراشدية
2017,1053,16,363,AL RASHIDIYA,الراشدية
2018,1053,15,378,AL RASHIDIYA,الراشدية
2019,1053,22,400,AL RASHIDIYA,الراشدية
2020,1053,74,474,AL RASHIDIYA,الراشدية
2021,1053,0,474,AL RASHIDIYA,الراشدية
1963,1093,0,0,AL BUTEEN,البطين
1964,1093,0,0,AL BUTEEN,البطين
1965,1093,0,0,AL BUTEEN,البطين
1966,1093,0,0,AL BUTEEN,البطين
1967,1093,0,0,AL BUTEEN,البطين
1968,1093,0,0,AL BUTEEN,البطين
1969,1093,0,0,AL BUTEEN,البطين
1970,1093,0,0,AL BUTEEN,البطين
1971,1093,0,0,AL BUTEEN,البطين
1972,1093,0,0,AL BUTEEN,البطين
1973,1093,0,0,AL BUTEEN,البطين
1974,1093,0,0,AL BUTEEN,البطين
1975,1093,0,0,AL BUTEEN,البطين
1976,1093,0,0,AL BUTEEN,البطين
1977,1093,0,0,AL BUTEEN,البطين
1978,1093,0,0,AL BUTEEN,البطين
1979,1093,0,0,AL BUTEEN,البطين
1980,1093,0,0,AL BUTEEN,البطين
1981,1093,0,0,AL BUTEEN,البطين
1982,1093,0,0,AL BUTEEN,البطين
1983,1093,0,0,AL BUTEEN,البطين
1984,1093,0,0,AL BUTEEN,البطين
1985,1093,0,0,AL BUTEEN,البطين
1986,1093,0,0,AL BUTEEN,البطين
1987,1093,0,0,AL BUTEEN,البطين
1988,1093,0,0,AL BUTEEN,البطين
1989,1093,0,0,AL BUTEEN,البطين
1990,1093,0,0,AL BUTEEN,البطين
1991,1093,0,0,AL BUTEEN,البطين
1992,1093,0,0,AL BUTEEN,البطين
1993,1093,0,0,AL BUTEEN,البطين
1994,1093,0,0,AL BUTEEN,البطين
1995,1093,0,0,AL BUTEEN,البطين
1996,1093,0,0,AL BUTEEN,البطين
1997,1093,0,0,AL BUTEEN,البطين
1998,1093,0,0,AL BUTEEN,البطين
1999,1093,0,0,AL BUTEEN,البطين
2000,1093,0,0,AL BUTEEN,البطين
2001,1093,0,0,AL BUTEEN,البطين
2002,1093,0,0,AL BUTEEN,البطين
2003,1093,0,0,AL BUTEEN,البطين
2004,1093,0,0,AL BUTEEN,البطين
2005,1093,0,0,AL BUTEEN,البطين
2006,1093,0,0,AL BUTEEN,البطين
2007,1093,0,0,AL BUTEEN,البطين
2008,1093,0,0,AL BUTEEN,البطين
2009,1093,0,0,AL BUTEEN,البطين
2010,1093,0,0,AL BUTEEN,البطين
2011,1093,0,0,AL BUTEEN,البطين
2012,1093,0,0,AL BUTEEN,البطين
2013,1093,0,0,AL BUTEEN,البطين
2014,1093,0,0,AL BUTEEN,البطين
2015,1093,0,0,AL BUTEEN,البطين
2016,1093,0,0,AL BUTEEN,البطين
2017,1093,0,0,AL BUTEEN,البطين
2018,1093,0,0,AL BUTEEN,البطين
2019,1093,1,1,AL BUTEEN,البطين
2020,1093,3,4,AL BUTEEN,البطين
2021,1093,0,4,AL BUTEEN,البطين
1963,1253,2,2,BURJ KHALIFA,برج خليفة
1964,1253,1,3,BURJ KHALIFA,برج خليفة
1965,1253,1,4,BURJ KHALIFA,برج خليفة
1966,1253,2,6,BURJ KHALIFA,برج خليفة
1967,1253,2,8,BURJ KHALIFA,برج خليفة
1968,1253,1,9,BURJ KHALIFA,برج خليفة
1969,1253,0,9,BURJ KHALIFA,برج خليفة
1970,1253,2,11,BURJ KHALIFA,برج خليفة
1971,1253,2,13,BURJ KHALIFA,برج خليفة
1972,1253,1,14,BURJ KHALIFA,برج خليفة
1973,1253,2,16,BURJ KHALIFA,برج خليفة
1974,1253,4,20,BURJ KHALIFA,برج خليفة
1975,1253,7,27,BURJ KHALIFA,برج خليفة
1976,1253,10,37,BURJ KHALIFA,برج خليفة
1977,1253,7,44,BURJ KHALIFA,برج خليفة
1978,1253,6,50,BURJ KHALIFA,برج خليفة
1979,1253,4,54,BURJ KHALIFA,برج خليفة
1980,1253,11,65,BURJ KHALIFA,برج خليفة
1981,1253,6,71,BURJ KHALIFA,برج خليفة
1982,1253,13,84,BURJ KHALIFA,برج خليفة
1983,1253,13,97,BURJ KHALIFA,برج خليفة
1984,1253,10,107,BURJ KHALIFA,برج خليفة
1985,1253,11,118,BURJ KHALIFA,برج خليفة
1986,1253,10,128,BURJ KHALIFA,برج خليفة
1987,1253,8,136,BURJ KHALIFA,برج خليفة
1988,1253,16,152,BURJ KHALIFA,برج خليفة
1989,1253,14,166,BURJ KHALIFA,برج خليفة
1990,1253,18,184,BURJ KHALIFA,برج خليفة
1991,1253,21,205,BURJ KHALIFA,برج خليفة
1992,1253,27,232,BURJ KHALIFA,برج خليفة
1993,1253,27,259,BURJ KHALIFA,برج خليفة
1994,1253,43,302,BURJ KHALIFA,برج خليفة
1995,1253,43,345,BURJ KHALIFA,برج خليفة
1996,1253,47,392,BURJ KHALIFA,برج خليفة
1997,1253,57,449,BURJ KHALIFA,برج خليفة
1998,1253,45,494,BURJ KHALIFA,برج خليفة
1999,1253,60,554,BURJ KHALIFA,برج خليفة
2000,1253,70,624,BURJ KHALIFA,برج خليفة
2001,1253,82,706,BURJ KHALIFA,برج خليفة
2002,1253,100,806,BURJ KHALIFA,برج خليفة
2003,1253,128,934,BURJ KHALIFA,برج خليفة
2004,1253,152,1086,BURJ KHALIFA,برج خليفة
2005,1253,173,1259,BURJ KHALIFA,برج خليفة
2006,1253,200,1459,BURJ KHALIFA,برج خليفة
2007,1253,217,1676,BURJ KHALIFA,برج خليفة
2008,1253,332,2008,BURJ KHALIFA,برج خليفة
2009,1253,143,2151,BURJ KHALIFA,برج خليفة
2010,1253,182,2333,BURJ KHALIFA,برج خليفة
2011,1253,262,2595,BURJ KHALIFA,برج خليفة
2012,1253,406,3001,BURJ KHALIFA,برج خليفة
2013,1253,477,3478,BURJ KHALIFA,برج خليفة
2014,1253,549,4027,BURJ KHALIFA,برج خليفة
2015,1253,650,4677,BURJ KHALIFA,برج خليفة
2016,1253,635,5312,BURJ KHALIFA,برج خليفة
2017,1253,787,6099,BURJ KHALIFA,برج خليفة
2018,1253,944,7043,BURJ KHALIFA,برج خليفة
2019,1253,1520,8563,BURJ KHALIFA,برج خليفة
2020,1253,2292,10855,BURJ KHALIFA,برج خليفة
2021,1253,0,10855,BURJ KHALIFA,برج خليفة
1963,1293,0,0,AL WUHEIDA,الوحيدة
1964,1293,0,0,AL WUHEIDA,الوحيدة
1965,1293,0,0,AL WUHEIDA,الوحيدة
1966,1293,0,0,AL WUHEIDA,الوحيدة
1967,1293,0,0,AL WUHEIDA,الوحيدة
1968,1293,0,0,AL WUHEIDA,الوحيدة
1969,1293,0,0,AL WUHEIDA,الوحيدة
1970,1293,1,1,AL WUHEIDA,الوحيدة
1971,1293,0,1,AL WUHEIDA,الوحيدة
1972,1293,0,1,AL WUHEIDA,الوحيدة
1973,1293,0,1,AL WUHEIDA,الوحيدة
1974,1293,1,2,AL WUHEIDA,الوحيدة
1975,1293,0,2,AL WUHEIDA,الوحيدة
1976,1293,1,3,AL WUHEIDA,الوحيدة
1977,1293,1,4,AL WUHEIDA,الوحيدة
1978,1293,0,4,AL WUHEIDA,الوحيدة
1979,1293,1,5,AL WUHEIDA,الوحيدة
1980,1293,0,5,AL WUHEIDA,الوحيدة
1981,1293,1,6,AL WUHEIDA,الوحيدة
1982,1293,1,7,AL WUHEIDA,الوحيدة
1983,1293,0,7,AL WUHEIDA,الوحيدة
1984,1293,2,9,AL WUHEIDA,الوحيدة
1985,1293,0,9,AL WUHEIDA,الوحيدة
1986,1293,1,10,AL WUHEIDA,الوحيدة
1987,1293,1,11,AL WUHEIDA,الوحيدة
1988,1293,2,13,AL WUHEIDA,الوحيدة
1989,1293,1,14,AL WUHEIDA,الوحيدة
1990,1293,0,14,AL WUHEIDA,الوحيدة
1991,1293,4,18,AL WUHEIDA,الوحيدة
1992,1293,1,19,AL WUHEIDA,الوحيدة
1993,1293,4,23,AL WUHEIDA,الوحيدة
1994,1293,4,27,AL WUHEIDA,الوحيدة
1995,1293,2,29,AL WUHEIDA,الوحيدة
1996,1293,0,29,AL WUHEIDA,الوحيدة
1997,1293,2,31,AL WUHEIDA,الوحيدة
1998,1293,3,34,AL WUHEIDA,الوحيدة
1999,1293,2,36,AL WUHEIDA,الوحيدة
2000,1293,7,43,AL WUHEIDA,الوحيدة
2001,1293,8,51,AL WUHEIDA,الوحيدة
2002,1293,4,55,AL WUHEIDA,الوحيدة
2003,1293,5,60,AL WUHEIDA,الوحيدة
2004,1293,0,60,AL WUHEIDA,الوحيدة
2005,1293,5,65,AL WUHEIDA,الوحيدة
2006,1293,1,66,AL WUHEIDA,الوحيدة
2007,1293,2,68,AL WUHEIDA,الوحيدة
2008,1293,1,69,AL WUHEIDA,الوحيدة
2009,1293,0,69,AL WUHEIDA,الوحيدة
2010,1293,0,69,AL WUHEIDA,الوحيدة
2011,1293,1,70,AL WUHEIDA,الوحيدة
2012,1293,2,72,AL WUHEIDA,الوحيدة
2013,1293,5,77,AL WUHEIDA,الوحيدة
2014,1293,0,77,AL WUHEIDA,الوحيدة
2015,1293,0,77,AL WUHEIDA,الوحيدة
2016,1293,0,77,AL WUHEIDA,الوحيدة
2017,1293,2,79,AL WUHEIDA,الوحيدة
2018,1293,4,83,AL WUHEIDA,الوحيدة
2019,1293,2,85,AL WUHEIDA,الوحيدة
2020,1293,3,88,AL WUHEIDA,الوحيدة
2021,1293,0,88,AL WUHEIDA,الوحيدة
1963,1333,0,0,AL QUSAIS IND. FOURTH,القصيص الصناعية الرابعة
1964,1333,0,0,AL QUSAIS IND. FOURTH,القصيص الصناعية الرابعة
1965,1333,0,0,AL QUSAIS IND. FOURTH,القصيص الصناعية الرابعة
1966,1333,0,0,AL QUSAIS IND. FOURTH,القصيص الصناعية الرابعة
1967,1333,0,0,AL QUSAIS IND. FOURTH,القصيص الصناعية الرابعة
1968,1333,0,0,AL QUSAIS IND. FOURTH,القصيص الصناعية الرابعة
1969,1333,1,1,AL QUSAIS IND. FOURTH,القصيص الصناعية الرابعة
1970,1333,0,1,AL QUSAIS IND. FOURTH,القصيص الصناعية الرابعة
1971,1333,0,1,AL QUSAIS IND. FOURTH,القصيص الصناعية الرابعة
1972,1333,1,2,AL QUSAIS IND. FOURTH,القصيص الصناعية الرابعة
1973,1333,0,2,AL QUSAIS IND. FOURTH,القصيص الصناعية الرابعة
1974,1333,0,2,AL QUSAIS IND. FOURTH,القصيص الصناعية الرابعة
1975,1333,1,3,AL QUSAIS IND. FOURTH,القصيص الصناعية الرابعة
1976,1333,0,3,AL QUSAIS IND. FOURTH,القصيص الصناعية الرابعة
1977,1333,0,3,AL QUSAIS IND. FOURTH,القصيص الصناعية الرابعة
1978,1333,2,5,AL QUSAIS IND. FOURTH,القصيص الصناعية الرابعة
1979,1333,0,5,AL QUSAIS IND. FOURTH,القصيص الصناعية الرابعة
1980,1333,1,6,AL QUSAIS IND. FOURTH,القصيص الصناعية الرابعة
1981,1333,0,6,AL QUSAIS IND. FOURTH,القصيص الصناعية الرابعة
1982,1333,0,6,AL QUSAIS IND. FOURTH,القصيص الصناعية الرابعة
1983,1333,1,7,AL QUSAIS IND. FOURTH,القصيص الصناعية الرابعة
1984,1333,1,8,AL QUSAIS IND. FOURTH,القصيص الصناعية الرابعة
1985,1333,0,8,AL QUSAIS IND. FOURTH,القصيص الصناعية الرابعة
1986,1333,2,10,AL QUSAIS IND. FOURTH,القصيص الصناعية الرابعة
1987,1333,1,11,AL QUSAIS IND. FOURTH,القصيص الصناعية الرابعة
1988,1333,1,12,AL QUSAIS IND. FOURTH,القصيص الصناعية الرابعة
1989,1333,4,16,AL QUSAIS IND. FOURTH,القصيص الصناعية الرابعة
1990,1333,2,18,AL QUSAIS IND. FOURTH,القصيص الصناعية الرابعة
1991,1333,1,19,AL QUSAIS IND. FOURTH,القصيص الصناعية الرابعة
1992,1333,1,20,AL QUSAIS IND. FOURTH,القصيص الصناعية الرابعة
1993,1333,2,22,AL QUSAIS IND. FOURTH,القصيص الصناعية الرابعة
1994,1333,6,28,AL QUSAIS IND. FOURTH,القصيص الصناعية الرابعة
1995,1333,6,34,AL QUSAIS IND. FOURTH,القصيص الصناعية الرابعة
1996,1333,2,36,AL QUSAIS IND. FOURTH,القصيص الصناعية الرابعة
1997,1333,4,40,AL QUSAIS IND. FOURTH,القصيص الصناعية الرابعة
1998,1333,3,43,AL QUSAIS IND. FOURTH,القصيص الصناعية الرابعة
1999,1333,2,45,AL QUSAIS IND. FOURTH,القصيص الصناعية الرابعة
2000,1333,4,49,AL QUSAIS IND. FOURTH,القصيص الصناعية الرابعة
2001,1333,7,56,AL QUSAIS IND. FOURTH,القصيص الصناعية الرابعة
2002,1333,3,59,AL QUSAIS IND. FOURTH,القصيص الصناعية الرابعة
2003,1333,12,71,AL QUSAIS IND. FOURTH,القصيص الصناعية الرابعة
2004,1333,7,78,AL QUSAIS IND. FOURTH,القصيص الصناعية الرابعة
2005,1333,14,92,AL QUSAIS IND. FOURTH,القصيص الصناعية الرابعة
2006,1333,11,103,AL QUSAIS IND. FOURTH,القصيص الصناعية الرابعة
2007,1333,16,119,AL QUSAIS IND. FOURTH,القصيص الصناعية الرابعة
2008,1333,17,136,AL QUSAIS IND. FOURTH,القصيص الصناعية الرابعة
2009,1333,5,141,AL QUSAIS IND. FOURTH,القصيص الصناعية الرابعة
2010,1333,11,152,AL QUSAIS IND. FOURTH,القصيص الصناعية الرابعة
2011,1333,15,167,AL QUSAIS IND. FOURTH,القصيص الصناعية الرابعة
2012,1333,14,181,AL QUSAIS IND. FOURTH,القصيص الصناعية الرابعة
2013,1333,31,212,AL QUSAIS IND. FOURTH,القصيص الصناعية الرابعة
2014,1333,24,236,AL QUSAIS IND. FOURTH,القصيص الصناعية الرابعة
2015,1333,24,260,AL QUSAIS IND. FOURTH,القصيص الصناعية الرابعة
2016,1333,19,279,AL QUSAIS IND. FOURTH,القصيص الصناعية الرابعة
2017,1333,37,316,AL QUSAIS IND. FOURTH,القصيص الصناعية الرابعة
2018,1333,19,335,AL QUSAIS IND. FOURTH,القصيص الصناعية الرابعة
2019,1333,40,375,AL QUSAIS IND. FOURTH,القصيص الصناعية الرابعة
2020,1333,56,431,AL QUSAIS IND. FOURTH,القصيص الصناعية الرابعة
2021,1333,0,431,AL QUSAIS IND. FOURTH,القصيص الصناعية الرابعة
1963,1373,0,0,OUD METHA,عود ميثاء
1964,1373,0,0,OUD METHA,عود ميثاء
1965,1373,0,0,OUD METHA,عود ميثاء
1966,1373,0,0,OUD METHA,عود ميثاء
1967,1373,0,0,OUD METHA,عود ميثاء
1968,1373,0,0,OUD METHA,عود ميثاء
1969,1373,1,1,OUD METHA,عود ميثاء
1970,1373,3,4,OUD METHA,عود ميثاء
1971,1373,0,4,OUD METHA,عود ميثاء
1972,1373,0,4,OUD METHA,عود ميثاء
1973,1373,1,5,OUD METHA,عود ميثاء
1974,1373,1,6,OUD METHA,عود ميثاء
1975,1373,2,8,OUD METHA,عود ميثاء
1976,1373,3,11,OUD METHA,عود ميثاء
1977,1373,3,14,OUD METHA,عود ميثاء
1978,1373,4,18,OUD METHA,عود ميثاء
1979,1373,6,24,OUD METHA,عود ميثاء
1980,1373,1,25,OUD METHA,عود ميثاء
1981,1373,1,26,OUD METHA,عود ميثاء
1982,1373,3,29,OUD METHA,عود ميثاء
1983,1373,3,32,OUD METHA,عود ميثاء
1984,1373,4,36,OUD METHA,عود ميثاء
1985,1373,2,38,OUD METHA,عود ميثاء
1986,1373,4,42,OUD METHA,عود ميثاء
1987,1373,4,46,OUD METHA,عود ميثاء
1988,1373,5,51,OUD METHA,عود ميثاء
1989,1373,4,55,OUD METHA,عود ميثاء
1990,1373,4,59,OUD METHA,عود ميثاء
1991,1373,6,65,OUD METHA,عود ميثاء
1992,1373,8,73,OUD METHA,عود ميثاء
1993,1373,7,80,OUD METHA,عود ميثاء
1994,1373,3,83,OUD METHA,عود ميثاء
1995,1373,10,93,OUD METHA,عود ميثاء
1996,1373,7,100,OUD METHA,عود ميثاء
1997,1373,13,113,OUD METHA,عود ميثاء
1998,1373,13,126,OUD METHA,عود ميثاء
1999,1373,18,144,OUD METHA,عود ميثاء
2000,1373,17,161,OUD METHA,عود ميثاء
2001,1373,20,181,OUD METHA,عود ميثاء
2002,1373,30,211,OUD METHA,عود ميثاء
2003,1373,30,241,OUD METHA,عود ميثاء
2004,1373,46,287,OUD METHA,عود ميثاء
2005,1373,29,316,OUD METHA,عود ميثاء
2006,1373,49,365,OUD METHA,عود ميثاء
2007,1373,37,402,OUD METHA,عود ميثاء
2008,1373,42,444,OUD METHA,عود ميثاء
2009,1373,55,499,OUD METHA,عود ميثاء
2010,1373,52,551,OUD METHA,عود ميثاء
2011,1373,60,611,OUD METHA,عود ميثاء
2012,1373,67,678,OUD METHA,عود ميثاء
2013,1373,81,759,OUD METHA,عود ميثاء
2014,1373,62,821,OUD METHA,عود ميثاء
2015,1373,98,919,OUD METHA,عود ميثاء
2016,1373,89,1008,OUD METHA,عود ميثاء
2017,1373,99,1107,OUD METHA,عود ميثاء
2018,1373,115,1222,OUD METHA,عود ميثاء
2019,1373,232,1454,OUD METHA,عود ميثاء
2020,1373,743,2197,OUD METHA,عود ميثاء
2021,1373,0,2197,OUD METHA,عود ميثاء
1963,1413,0,0,AL AWIR SECOND,العوير الثانية
1964,1413,0,0,AL AWIR SECOND,العوير الثانية
1965,1413,0,0,AL AWIR SECOND,العوير الثانية
1966,1413,0,0,AL AWIR SECOND,العوير الثانية
1967,1413,0,0,AL AWIR SECOND,العوير الثانية
1968,1413,0,0,AL AWIR SECOND,العوير الثانية
1969,1413,0,0,AL AWIR SECOND,العوير الثانية
1970,1413,0,0,AL AWIR SECOND,العوير الثانية
1971,1413,0,0,AL AWIR SECOND,العوير الثانية
1972,1413,0,0,AL AWIR SECOND,العوير الثانية
1973,1413,1,1,AL AWIR SECOND,العوير الثانية
1974,1413,0,1,AL AWIR SECOND,العوير الثانية
1975,1413,0,1,AL AWIR SECOND,العوير الثانية
1976,1413,0,1,AL AWIR SECOND,العوير الثانية
1977,1413,0,1,AL AWIR SECOND,العوير الثانية
1978,1413,1,2,AL AWIR SECOND,العوير الثانية
1979,1413,0,2,AL AWIR SECOND,العوير الثانية
1980,1413,0,2,AL AWIR SECOND,العوير الثانية
1981,1413,0,2,AL AWIR SECOND,العوير الثانية
1982,1413,1,3,AL AWIR SECOND,العوير الثانية
1983,1413,0,3,AL AWIR SECOND,العوير الثانية
1984,1413,0,3,AL AWIR SECOND,العوير الثانية
1985,1413,1,4,AL AWIR SECOND,العوير الثانية
1986,1413,1,5,AL AWIR SECOND,العوير الثانية
1987,1413,0,5,AL AWIR SECOND,العوير الثانية
1988,1413,1,6,AL AWIR SECOND,العوير الثانية
1989,1413,0,6,AL AWIR SECOND,العوير الثانية
1990,1413,0,6,AL AWIR SECOND,العوير الثانية
1991,1413,1,7,AL AWIR SECOND,العوير الثانية
1992,1413,1,8,AL AWIR SECOND,العوير الثانية
1993,1413,2,10,AL AWIR SECOND,العوير الثانية
1994,1413,0,10,AL AWIR SECOND,العوير الثانية
1995,1413,1,11,AL AWIR SECOND,العوير الثانية
1996,1413,2,13,AL AWIR SECOND,العوير الثانية
1997,1413,0,13,AL AWIR SECOND,العوير الثانية
1998,1413,0,13,AL AWIR SECOND,العوير الثانية
1999,1413,0,13,AL AWIR SECOND,العوير الثانية
2000,1413,0,13,AL AWIR SECOND,العوير الثانية
2001,1413,0,13,AL AWIR SECOND,العوير الثانية
2002,1413,0,13,AL AWIR SECOND,العوير الثانية
2003,1413,1,14,AL AWIR SECOND,العوير الثانية
2004,1413,1,15,AL AWIR SECOND,العوير الثانية
2005,1413,0,15,AL AWIR SECOND,العوير الثانية
2006,1413,0,15,AL AWIR SECOND,العوير الثانية
2007,1413,0,15,AL AWIR SECOND,العوير الثانية
2008,1413,3,18,AL AWIR SECOND,العوير الثانية
2009,1413,0,18,AL AWIR SECOND,العوير الثانية
2010,1413,4,22,AL AWIR SECOND,العوير الثانية
2011,1413,1,23,AL AWIR SECOND,العوير الثانية
2012,1413,3,26,AL AWIR SECOND,العوير الثانية
2013,1413,3,29,AL AWIR SECOND,العوير الثانية
2014,1413,1,30,AL AWIR SECOND,العوير الثانية
2015,1413,6,36,AL AWIR SECOND,العوير الثانية
2016,1413,2,38,AL AWIR SECOND,العوير الثانية
2017,1413,4,42,AL AWIR SECOND,العوير الثانية
2018,1413,3,45,AL AWIR SECOND,العوير الثانية
2019,1413,8,53,AL AWIR SECOND,العوير الثانية
2020,1413,9,62,AL AWIR SECOND,العوير الثانية
2021,1413,0,62,AL AWIR SECOND,العوير الثانية
1963,1493,0,0,AL TTAY,الطي
1964,1493,0,0,AL TTAY,الطي
1965,1493,0,0,AL TTAY,الطي
1966,1493,0,0,AL TTAY,الطي
1967,1493,0,0,AL TTAY,الطي
1968,1493,0,0,AL TTAY,الطي
1969,1493,0,0,AL TTAY,الطي
1970,1493,0,0,AL TTAY,الطي
1971,1493,0,0,AL TTAY,الطي
1972,1493,0,0,AL TTAY,الطي
1973,1493,0,0,AL TTAY,الطي
1974,1493,0,0,AL TTAY,الطي
1975,1493,0,0,AL TTAY,الطي
1976,1493,0,0,AL TTAY,الطي
1977,1493,0,0,AL TTAY,الطي
1978,1493,0,0,AL TTAY,الطي
1979,1493,0,0,AL TTAY,الطي
1980,1493,0,0,AL TTAY,الطي
1981,1493,0,0,AL TTAY,الطي
1982,1493,0,0,AL TTAY,الطي
1983,1493,0,0,AL TTAY,الطي
1984,1493,0,0,AL TTAY,الطي
1985,1493,0,0,AL TTAY,الطي
1986,1493,0,0,AL TTAY,الطي
1987,1493,0,0,AL TTAY,الطي
1988,1493,0,0,AL TTAY,الطي
1989,1493,0,0,AL TTAY,الطي
1990,1493,0,0,AL TTAY,الطي
1991,1493,0,0,AL TTAY,الطي
1992,1493,0,0,AL TTAY,الطي
1993,1493,0,0,AL TTAY,الطي
1994,1493,0,0,AL TTAY,الطي
1995,1493,0,0,AL TTAY,الطي
1996,1493,0,0,AL TTAY,الطي
1997,1493,0,0,AL TTAY,الطي
1998,1493,0,0,AL TTAY,الطي
1999,1493,0,0,AL TTAY,الطي
2000,1493,0,0,AL TTAY,الطي
2001,1493,0,0,AL TTAY,الطي
2002,1493,0,0,AL TTAY,الطي
2003,1493,0,0,AL TTAY,الطي
2004,1493,0,0,AL TTAY,الطي
2005,1493,0,0,AL TTAY,الطي
2006,1493,0,0,AL TTAY,الطي
2007,1493,0,0,AL TTAY,الطي
2008,1493,0,0,AL TTAY,الطي
2009,1493,0,0,AL TTAY,الطي
2010,1493,0,0,AL TTAY,الطي
2011,1493,0,0,AL TTAY,الطي
2012,1493,0,0,AL TTAY,الطي
2013,1493,0,0,AL TTAY,الطي
2014,1493,0,0,AL TTAY,الطي
2015,1493,0,0,AL TTAY,الطي
2016,1493,0,0,AL TTAY,الطي
2017,1493,0,0,AL TTAY,الطي
2018,1493,0,0,AL TTAY,الطي
2019,1493,0,0,AL TTAY,الطي
2020,1493,1,1,AL TTAY,الطي
2021,1493,0,1,AL TTAY,الطي
1963,1533,0,0,AL YALAYIS 2,اليلايس 2
1964,1533,0,0,AL YALAYIS 2,اليلايس 2
1965,1533,0,0,AL YALAYIS 2,اليلايس 2
1966,1533,0,0,AL YALAYIS 2,اليلايس 2
1967,1533,0,0,AL YALAYIS 2,اليلايس 2
1968,1533,0,0,AL YALAYIS 2,اليلايس 2
1969,1533,0,0,AL YALAYIS 2,اليلايس 2
1970,1533,0,0,AL YALAYIS 2,اليلايس 2
1971,1533,0,0,AL YALAYIS 2,اليلايس 2
1972,1533,0,0,AL YALAYIS 2,اليلايس 2
1973,1533,0,0,AL YALAYIS 2,اليلايس 2
1974,1533,0,0,AL YALAYIS 2,اليلايس 2
1975,1533,0,0,AL YALAYIS 2,اليلايس 2
1976,1533,0,0,AL YALAYIS 2,اليلايس 2
1977,1533,0,0,AL YALAYIS 2,اليلايس 2
1978,1533,0,0,AL YALAYIS 2,اليلايس 2
1979,1533,0,0,AL YALAYIS 2,اليلايس 2
1980,1533,0,0,AL YALAYIS 2,اليلايس 2
1981,1533,0,0,AL YALAYIS 2,اليلايس 2
1982,1533,0,0,AL YALAYIS 2,اليلايس 2
1983,1533,0,0,AL YALAYIS 2,اليلايس 2
1984,1533,0,0,AL YALAYIS 2,اليلايس 2
1985,1533,0,0,AL YALAYIS 2,اليلايس 2
1986,1533,0,0,AL YALAYIS 2,اليلايس 2
1987,1533,0,0,AL YALAYIS 2,اليلايس 2
1988,1533,0,0,AL YALAYIS 2,اليلايس 2
1989,1533,0,0,AL YALAYIS 2,اليلايس 2
1990,1533,0,0,AL YALAYIS 2,اليلايس 2
1991,1533,0,0,AL YALAYIS 2,اليلايس 2
1992,1533,0,0,AL YALAYIS 2,اليلايس 2
1993,1533,0,0,AL YALAYIS 2,اليلايس 2
1994,1533,0,0,AL YALAYIS 2,اليلايس 2
1995,1533,0,0,AL YALAYIS 2,اليلايس 2
1996,1533,0,0,AL YALAYIS 2,اليلايس 2
1997,1533,0,0,AL YALAYIS 2,اليلايس 2
1998,1533,0,0,AL YALAYIS 2,اليلايس 2
1999,1533,0,0,AL YALAYIS 2,اليلايس 2
2000,1533,0,0,AL YALAYIS 2,اليلايس 2
2001,1533,0,0,AL YALAYIS 2,اليلايس 2
2002,1533,0,0,AL YALAYIS 2,اليلايس 2
2003,1533,0,0,AL YALAYIS 2,اليلايس 2
2004,1533,0,0,AL YALAYIS 2,اليلايس 2
2005,1533,0,0,AL YALAYIS 2,اليلايس 2
2006,1533,1,1,AL YALAYIS 2,اليلايس 2
2007,1533,0,1,AL YALAYIS 2,اليلايس 2
2008,1533,0,1,AL YALAYIS 2,اليلايس 2
2009,1533,0,1,AL YALAYIS 2,اليلايس 2
2010,1533,0,1,AL YALAYIS 2,اليلايس 2
2011,1533,0,1,AL YALAYIS 2,اليلايس 2
2012,1533,0,1,AL YALAYIS 2,اليلايس 2
2013,1533,0,1,AL YALAYIS 2,اليلايس 2
2014,1533,0,1,AL YALAYIS 2,اليلايس 2
2015,1533,0,1,AL YALAYIS 2,اليلايس 2
2016,1533,0,1,AL YALAYIS 2,اليلايس 2
2017,1533,0,1,AL YALAYIS 2,اليلايس 2
2018,1533,2,3,AL YALAYIS 2,اليلايس 2
2019,1533,4,7,AL YALAYIS 2,اليلايس 2
2020,1533,21,28,AL YALAYIS 2,اليلايس 2
2021,1533,0,28,AL YALAYIS 2,اليلايس 2
1963,1573,0,0,AL QUSAIS IND. FIFTH,القصيص الصناعية الخامسة
1964,1573,0,0,AL QUSAIS IND. FIFTH,القصيص الصناعية الخامسة
1965,1573,0,0,AL QUSAIS IND. FIFTH,القصيص الصناعية الخامسة
1966,1573,0,0,AL QUSAIS IND. FIFTH,القصيص الصناعية الخامسة
1967,1573,0,0,AL QUSAIS IND. FIFTH,القصيص الصناعية الخامسة
1968,1573,0,0,AL QUSAIS IND. FIFTH,القصيص الصناعية الخامسة
1969,1573,0,0,AL QUSAIS IND. FIFTH,القصيص الصناعية الخامسة
1970,1573,0,0,AL QUSAIS IND. FIFTH,القصيص الصناعية الخامسة
1971,1573,0,0,AL QUSAIS IND. FIFTH,القصيص الصناعية الخامسة
1972,1573,1,1,AL QUSAIS IND. FIFTH,القصيص الصناعية الخامسة
1973,1573,0,1,AL QUSAIS IND. FIFTH,القصيص الصناعية الخامسة
1974,1573,0,1,AL QUSAIS IND. FIFTH,القصيص الصناعية الخامسة
1975,1573,0,1,AL QUSAIS IND. FIFTH,القصيص الصناعية الخامسة
1976,1573,1,2,AL QUSAIS IND. FIFTH,القصيص الصناعية الخامسة
1977,1573,1,3,AL QUSAIS IND. FIFTH,القصيص الصناعية الخامسة
1978,1573,0,3,AL QUSAIS IND. FIFTH,القصيص الصناعية الخامسة
1979,1573,0,3,AL QUSAIS IND. FIFTH,القصيص الصناعية الخامسة
1980,1573,0,3,AL QUSAIS IND. FIFTH,القصيص الصناعية الخامسة
1981,1573,0,3,AL QUSAIS IND. FIFTH,القصيص الصناعية الخامسة
1982,1573,0,3,AL QUSAIS IND. FIFTH,القصيص الصناعية الخامسة
1983,1573,0,3,AL QUSAIS IND. FIFTH,القصيص الصناعية الخامسة
1984,1573,0,3,AL QUSAIS IND. FIFTH,القصيص الصناعية الخامسة
1985,1573,0,3,AL QUSAIS IND. FIFTH,القصيص الصناعية الخامسة
1986,1573,1,4,AL QUSAIS IND. FIFTH,القصيص الصناعية الخامسة
1987,1573,0,4,AL QUSAIS IND. FIFTH,القصيص الصناعية الخامسة
1988,1573,0,4,AL QUSAIS IND. FIFTH,القصيص الصناعية الخامسة
1989,1573,0,4,AL QUSAIS IND. FIFTH,القصيص الصناعية الخامسة
1990,1573,0,4,AL QUSAIS IND. FIFTH,القصيص الصناعية الخامسة
1991,1573,2,6,AL QUSAIS IND. FIFTH,القصيص الصناعية الخامسة
1992,1573,1,7,AL QUSAIS IND. FIFTH,القصيص الصناعية الخامسة
1993,1573,1,8,AL QUSAIS IND. FIFTH,القصيص الصناعية الخامسة
1994,1573,1,9,AL QUSAIS IND. FIFTH,القصيص الصناعية الخامسة
1995,1573,1,10,AL QUSAIS IND. FIFTH,القصيص الصناعية الخامسة
1996,1573,0,10,AL QUSAIS IND. FIFTH,القصيص الصناعية الخامسة
1997,1573,2,12,AL QUSAIS IND. FIFTH,القصيص الصناعية الخامسة
1998,1573,2,14,AL QUSAIS IND. FIFTH,القصيص الصناعية الخامسة
1999,1573,1,15,AL QUSAIS IND. FIFTH,القصيص الصناعية الخامسة
2000,1573,4,19,AL QUSAIS IND. FIFTH,القصيص الصناعية الخامسة
2001,1573,2,21,AL QUSAIS IND. FIFTH,القصيص الصناعية الخامسة
2002,1573,7,28,AL QUSAIS IND. FIFTH,القصيص الصناعية الخامسة
2003,1573,1,29,AL QUSAIS IND. FIFTH,القصيص الصناعية الخامسة
2004,1573,3,32,AL QUSAIS IND. FIFTH,القصيص الصناعية الخامسة
2005,1573,3,35,AL QUSAIS IND. FIFTH,القصيص الصناعية الخامسة
2006,1573,5,40,AL QUSAIS IND. FIFTH,القصيص الصناعية الخامسة
2007,1573,5,45,AL QUSAIS IND. FIFTH,القصيص الصناعية الخامسة
2008,1573,0,45,AL QUSAIS IND. FIFTH,القصيص الصناعية الخامسة
2009,1573,3,48,AL QUSAIS IND. FIFTH,القصيص الصناعية الخامسة
2010,1573,7,55,AL QUSAIS IND. FIFTH,القصيص الصناعية الخامسة
2011,1573,7,62,AL QUSAIS IND. FIFTH,القصيص الصناعية الخامسة
2012,1573,4,66,AL QUSAIS IND. FIFTH,القصيص الصناعية الخامسة
2013,1573,4,70,AL QUSAIS IND. FIFTH,القصيص الصناعية الخامسة
2014,1573,17,87,AL QUSAIS IND. FIFTH,القصيص الصناعية الخامسة
2015,1573,8,95,AL QUSAIS IND. FIFTH,القصيص الصناعية الخامسة
2016,1573,12,107,AL QUSAIS IND. FIFTH,القصيص الصناعية الخامسة
2017,1573,6,113,AL QUSAIS IND. FIFTH,القصيص الصناعية الخامسة
2018,1573,7,120,AL QUSAIS IND. FIFTH,القصيص الصناعية الخامسة
2019,1573,17,137,AL QUSAIS IND. FIFTH,القصيص الصناعية الخامسة
2020,1573,22,159,AL QUSAIS IND. FIFTH,القصيص الصناعية الخامسة
2021,1573,0,159,AL QUSAIS IND. FIFTH,القصيص الصناعية الخامسة
1963,1613,0,0,UMM SUQEIM THIRD,أم سقيم الثالثة
1964,1613,0,0,UMM SUQEIM THIRD,أم سقيم الثالثة
1965,1613,0,0,UMM SUQEIM THIRD,أم سقيم الثالثة
1966,1613,0,0,UMM SUQEIM THIRD,أم سقيم الثالثة
1967,1613,0,0,UMM SUQEIM THIRD,أم سقيم الثالثة
1968,1613,0,0,UMM SUQEIM THIRD,أم سقيم الثالثة
1969,1613,0,0,UMM SUQEIM THIRD,أم سقيم الثالثة
1970,1613,0,0,UMM SUQEIM THIRD,أم سقيم الثالثة
1971,1613,0,0,UMM SUQEIM THIRD,أم سقيم الثالثة
1972,1613,0,0,UMM SUQEIM THIRD,أم سقيم الثالثة
1973,1613,0,0,UMM SUQEIM THIRD,أم سقيم الثالثة
1974,1613,0,0,UMM SUQEIM THIRD,أم سقيم الثالثة
1975,1613,0,0,UMM SUQEIM THIRD,أم سقيم الثالثة
1976,1613,0,0,UMM SUQEIM THIRD,أم سقيم الثالثة
1977,1613,0,0,UMM SUQEIM THIRD,أم سقيم الثالثة
1978,1613,0,0,UMM SUQEIM THIRD,أم سقيم الثالثة
1979,1613,0,0,UMM SUQEIM THIRD,أم سقيم الثالثة
1980,1613,0,0,UMM SUQEIM THIRD,أم سقيم الثالثة
1981,1613,0,0,UMM SUQEIM THIRD,أم سقيم الثالثة
1982,1613,0,0,UMM SUQEIM THIRD,أم سقيم الثالثة
1983,1613,0,0,UMM SUQEIM THIRD,أم سقيم الثالثة
1984,1613,0,0,UMM SUQEIM THIRD,أم سقيم الثالثة
1985,1613,0,0,UMM SUQEIM THIRD,أم سقيم الثالثة
1986,1613,0,0,UMM SUQEIM THIRD,أم سقيم الثالثة
1987,1613,0,0,UMM SUQEIM THIRD,أم سقيم الثالثة
1988,1613,0,0,UMM SUQEIM THIRD,أم سقيم الثالثة
1989,1613,2,2,UMM SUQEIM THIRD,أم سقيم الثالثة
1990,1613,0,2,UMM SUQEIM THIRD,أم سقيم الثالثة
1991,1613,0,2,UMM SUQEIM THIRD,أم سقيم الثالثة
1992,1613,0,2,UMM SUQEIM THIRD,أم سقيم الثالثة
1993,1613,0,2,UMM SUQEIM THIRD,أم سقيم الثالثة
1994,1613,1,3,UMM SUQEIM THIRD,أم سقيم الثالثة
1995,1613,0,3,UMM SUQEIM THIRD,أم سقيم الثالثة
1996,1613,1,4,UMM SUQEIM THIRD,أم سقيم الثالثة
1997,1613,0,4,UMM SUQEIM THIRD,أم سقيم الثالثة
1998,1613,0,4,UMM SUQEIM THIRD,أم سقيم الثالثة
1999,1613,1,5,UMM SUQEIM THIRD,أم سقيم الثالثة
2000,1613,2,7,UMM SUQEIM THIRD,أم سقيم الثالثة
2001,1613,1,8,UMM SUQEIM THIRD,أم سقيم الثالثة
2002,1613,0,8,UMM SUQEIM THIRD,أم سقيم الثالثة
2003,1613,1,9,UMM SUQEIM THIRD,أم سقيم الثالثة
2004,1613,6,15,UMM SUQEIM THIRD,أم سقيم الثالثة
2005,1613,9,24,UMM SUQEIM THIRD,أم سقيم الثالثة
2006,1613,7,31,UMM SUQEIM THIRD,أم سقيم الثالثة
2007,1613,8,39,UMM SUQEIM THIRD,أم سقيم الثالثة
2008,1613,5,44,UMM SUQEIM THIRD,أم سقيم الثالثة
2009,1613,2,46,UMM SUQEIM THIRD,أم سقيم الثالثة
2010,1613,7,53,UMM SUQEIM THIRD,أم سقيم الثالثة
2011,1613,2,55,UMM SUQEIM THIRD,أم سقيم الثالثة
2012,1613,4,59,UMM SUQEIM THIRD,أم سقيم الثالثة
2013,1613,8,67,UMM SUQEIM THIRD,أم سقيم الثالثة
2014,1613,9,76,UMM SUQEIM THIRD,أم سقيم الثالثة
2015,1613,11,87,UMM SUQEIM THIRD,أم سقيم الثالثة
2016,1613,11,98,UMM SUQEIM THIRD,أم سقيم الثالثة
2017,1613,7,105,UMM SUQEIM THIRD,أم سقيم الثالثة
2018,1613,27,132,UMM SUQEIM THIRD,أم سقيم الثالثة
2019,1613,25,157,UMM SUQEIM THIRD,أم سقيم الثالثة
2020,1613,29,186,UMM SUQEIM THIRD,أم سقيم الثالثة
2021,1613,0,186,UMM SUQEIM THIRD,أم سقيم الثالثة
1963,1653,2,2,AL CORNICHE,الكورنيش
1964,1653,1,3,AL CORNICHE,الكورنيش
1965,1653,0,3,AL CORNICHE,الكورنيش
1966,1653,0,3,AL CORNICHE,الكورنيش
1967,1653,0,3,AL CORNICHE,الكورنيش
1968,1653,0,3,AL CORNICHE,الكورنيش
1969,1653,0,3,AL CORNICHE,الكورنيش
1970,1653,0,3,AL CORNICHE,الكورنيش
1971,1653,1,4,AL CORNICHE,الكورنيش
1972,1653,0,4,AL CORNICHE,الكورنيش
1973,1653,2,6,AL CORNICHE,الكورنيش
1974,1653,0,6,AL CORNICHE,الكورنيش
1975,1653,1,7,AL CORNICHE,الكورنيش
1976,1653,0,7,AL CORNICHE,الكورنيش
1977,1653,2,9,AL CORNICHE,الكورنيش
1978,1653,0,9,AL CORNICHE,الكورنيش
1979,1653,0,9,AL CORNICHE,الكورنيش
1980,1653,1,10,AL CORNICHE,الكورنيش
1981,1653,2,12,AL CORNICHE,الكورنيش
1982,1653,7,19,AL CORNICHE,الكورنيش
1983,1653,21,40,AL CORNICHE,الكورنيش
1984,1653,5,45,AL CORNICHE,الكورنيش
1985,1653,26,71,AL CORNICHE,الكورنيش
1986,1653,8,79,AL CORNICHE,الكورنيش
1987,1653,4,83,AL CORNICHE,الكورنيش
1988,1653,18,101,AL CORNICHE,الكورنيش
1989,1653,3,104,AL CORNICHE,الكورنيش
1990,1653,0,104,AL CORNICHE,الكورنيش
1991,1653,1,105,AL CORNICHE,الكورنيش
1992,1653,4,109,AL CORNICHE,الكورنيش
1993,1653,2,111,AL CORNICHE,الكورنيش
1994,1653,3,114,AL CORNICHE,الكورنيش
1995,1653,2,116,AL CORNICHE,الكورنيش
1996,1653,0,116,AL CORNICHE,الكورنيش
1997,1653,83,199,AL CORNICHE,الكورنيش
1998,1653,2,201,AL CORNICHE,الكورنيش
1999,1653,5,206,AL CORNICHE,الكورنيش
2000,1653,1,207,AL CORNICHE,الكورنيش
2001,1653,2,209,AL CORNICHE,الكورنيش
2002,1653,21,230,AL CORNICHE,الكورنيش
2003,1653,16,246,AL CORNICHE,الكورنيش
2004,1653,5,251,AL CORNICHE,الكورنيش
2005,1653,1,252,AL CORNICHE,الكورنيش
2006,1653,6,258,AL CORNICHE,الكورنيش
2007,1653,4,262,AL CORNICHE,الكورنيش
2008,1653,5,267,AL CORNICHE,الكورنيش
2009,1653,6,273,AL CORNICHE,الكورنيش
2010,1653,9,282,AL CORNICHE,الكورنيش
2011,1653,12,294,AL CORNICHE,الكورنيش
2012,1653,4,298,AL CORNICHE,الكورنيش
2013,1653,4,302,AL CORNICHE,الكورنيش
2014,1653,1,303,AL CORNICHE,الكورنيش
2015,1653,4,307,AL CORNICHE,الكورنيش
2016,1653,1,308,AL CORNICHE,الكورنيش
2017,1653,24,332,AL CORNICHE,الكورنيش
2018,1653,26,358,AL CORNICHE,الكورنيش
2019,1653,20,378,AL CORNICHE,الكورنيش
2020,1653,20,398,AL CORNICHE,الكورنيش
2021,1653,0,398,AL CORNICHE,الكورنيش
1963,1693,0,0,JABAL ALI INDUSTRIAL SECOND,جبل علي الصناعية الثانية
1964,1693,0,0,JABAL ALI INDUSTRIAL SECOND,جبل علي الصناعية الثانية
1965,1693,0,0,JABAL ALI INDUSTRIAL SECOND,جبل علي الصناعية الثانية
1966,1693,0,0,JABAL ALI INDUSTRIAL SECOND,جبل علي الصناعية الثانية
1967,1693,0,0,JABAL ALI INDUSTRIAL SECOND,جبل علي الصناعية الثانية
1968,1693,0,0,JABAL ALI INDUSTRIAL SECOND,جبل علي الصناعية الثانية
1969,1693,0,0,JABAL ALI INDUSTRIAL SECOND,جبل علي الصناعية الثانية
1970,1693,0,0,JABAL ALI INDUSTRIAL SECOND,جبل علي الصناعية الثانية
1971,1693,0,0,JABAL ALI INDUSTRIAL SECOND,جبل علي الصناعية الثانية
1972,1693,0,0,JABAL ALI INDUSTRIAL SECOND,جبل علي الصناعية الثانية
1973,1693,0,0,JABAL ALI INDUSTRIAL SECOND,جبل علي الصناعية الثانية
1974,1693,0,0,JABAL ALI INDUSTRIAL SECOND,جبل علي الصناعية الثانية
1975,1693,0,0,JABAL ALI INDUSTRIAL SECOND,جبل علي الصناعية الثانية
1976,1693,0,0,JABAL ALI INDUSTRIAL SECOND,جبل علي الصناعية الثانية
1977,1693,0,0,JABAL ALI INDUSTRIAL SECOND,جبل علي الصناعية الثانية
1978,1693,0,0,JABAL ALI INDUSTRIAL SECOND,جبل علي الصناعية الثانية
1979,1693,1,1,JABAL ALI INDUSTRIAL SECOND,جبل علي الصناعية الثانية
1980,1693,0,1,JABAL ALI INDUSTRIAL SECOND,جبل علي الصناعية الثانية
1981,1693,0,1,JABAL ALI INDUSTRIAL SECOND,جبل علي الصناعية الثانية
1982,1693,0,1,JABAL ALI INDUSTRIAL SECOND,جبل علي الصناعية الثانية
1983,1693,0,1,JABAL ALI INDUSTRIAL SECOND,جبل علي الصناعية الثانية
1984,1693,0,1,JABAL ALI INDUSTRIAL SECOND,جبل علي الصناعية الثانية
1985,1693,0,1,JABAL ALI INDUSTRIAL SECOND,جبل علي الصناعية الثانية
1986,1693,0,1,JABAL ALI INDUSTRIAL SECOND,جبل علي الصناعية الثانية
1987,1693,0,1,JABAL ALI INDUSTRIAL SECOND,جبل علي الصناعية الثانية
1988,1693,0,1,JABAL ALI INDUSTRIAL SECOND,جبل علي الصناعية الثانية
1989,1693,0,1,JABAL ALI INDUSTRIAL SECOND,جبل علي الصناعية الثانية
1990,1693,0,1,JABAL ALI INDUSTRIAL SECOND,جبل علي الصناعية الثانية
1991,1693,1,2,JABAL ALI INDUSTRIAL SECOND,جبل علي الصناعية الثانية
1992,1693,1,3,JABAL ALI INDUSTRIAL SECOND,جبل علي الصناعية الثانية
1993,1693,0,3,JABAL ALI INDUSTRIAL SECOND,جبل علي الصناعية الثانية
1994,1693,0,3,JABAL ALI INDUSTRIAL SECOND,جبل علي الصناعية الثانية
1995,1693,0,3,JABAL ALI INDUSTRIAL SECOND,جبل علي الصناعية الثانية
1996,1693,0,3,JABAL ALI INDUSTRIAL SECOND,جبل علي الصناعية الثانية
1997,1693,0,3,JABAL ALI INDUSTRIAL SECOND,جبل علي الصناعية الثانية
1998,1693,1,4,JABAL ALI INDUSTRIAL SECOND,جبل علي الصناعية الثانية
1999,1693,1,5,JABAL ALI INDUSTRIAL SECOND,جبل علي الصناعية الثانية
2000,1693,1,6,JABAL ALI INDUSTRIAL SECOND,جبل علي الصناعية الثانية
2001,1693,0,6,JABAL ALI INDUSTRIAL SECOND,جبل علي الصناعية الثانية
2002,1693,0,6,JABAL ALI INDUSTRIAL SECOND,جبل علي الصناعية الثانية
2003,1693,2,8,JABAL ALI INDUSTRIAL SECOND,جبل علي الصناعية الثانية
2004,1693,1,9,JABAL ALI INDUSTRIAL SECOND,جبل علي الصناعية الثانية
2005,1693,0,9,JABAL ALI INDUSTRIAL SECOND,جبل علي الصناعية الثانية
2006,1693,1,10,JABAL ALI INDUSTRIAL SECOND,جبل علي الصناعية الثانية
2007,1693,1,11,JABAL ALI INDUSTRIAL SECOND,جبل علي الصناعية الثانية
2008,1693,2,13,JABAL ALI INDUSTRIAL SECOND,جبل علي الصناعية الثانية
2009,1693,0,13,JABAL ALI INDUSTRIAL SECOND,جبل علي الصناعية الثانية
2010,1693,0,13,JABAL ALI INDUSTRIAL SECOND,جبل علي الصناعية الثانية
2011,1693,1,14,JABAL ALI INDUSTRIAL SECOND,جبل علي الصناعية الثانية
2012,1693,0,14,JABAL ALI INDUSTRIAL SECOND,جبل علي الصناعية الثانية
2013,1693,4,18,JABAL ALI INDUSTRIAL SECOND,جبل علي الصناعية الثانية
2014,1693,1,19,JABAL ALI INDUSTRIAL SECOND,جبل علي الصناعية الثانية
2015,1693,2,21,JABAL ALI INDUSTRIAL SECOND,جبل علي الصناعية الثانية
2016,1693,4,25,JABAL ALI INDUSTRIAL SECOND,جبل علي الصناعية الثانية
2017,1693,3,28,JABAL ALI INDUSTRIAL SECOND,جبل علي الصناعية الثانية
2018,1693,1,29,JABAL ALI INDUSTRIAL SECOND,جبل علي الصناعية الثانية
2019,1693,5,34,JABAL ALI INDUSTRIAL SECOND,جبل علي الصناعية الثانية
2020,1693,5,39,JABAL ALI INDUSTRIAL SECOND,جبل علي الصناعية الثانية
2021,1693,0,39,JABAL ALI INDUSTRIAL SECOND,جبل علي الصناعية الثانية
1963,1733,0,0,NADD AL SHIBA FIRST,ند الشبا الأولى
1964,1733,0,0,NADD AL SHIBA FIRST,ند الشبا الأولى
1965,1733,0,0,NADD AL SHIBA FIRST,ند الشبا الأولى
1966,1733,0,0,NADD AL SHIBA FIRST,ند الشبا الأولى
1967,1733,0,0,NADD AL SHIBA FIRST,ند الشبا الأولى
1968,1733,0,0,NADD AL SHIBA FIRST,ند الشبا الأولى
1969,1733,0,0,NADD AL SHIBA FIRST,ند الشبا الأولى
1970,1733,0,0,NADD AL SHIBA FIRST,ند الشبا الأولى
1971,1733,0,0,NADD AL SHIBA FIRST,ند الشبا الأولى
1972,1733,0,0,NADD AL SHIBA FIRST,ند الشبا الأولى
1973,1733,0,0,NADD AL SHIBA FIRST,ند الشبا الأولى
1974,1733,0,0,NADD AL SHIBA FIRST,ند الشبا الأولى
1975,1733,2,2,NADD AL SHIBA FIRST,ند الشبا الأولى
1976,1733,1,3,NADD AL SHIBA FIRST,ند الشبا الأولى
1977,1733,1,4,NADD AL SHIBA FIRST,ند الشبا الأولى
1978,1733,0,4,NADD AL SHIBA FIRST,ند الشبا الأولى
1979,1733,0,4,NADD AL SHIBA FIRST,ند الشبا الأولى
1980,1733,0,4,NADD AL SHIBA FIRST,ند الشبا الأولى
1981,1733,1,5,NADD AL SHIBA FIRST,ند الشبا الأولى
1982,1733,1,6,NADD AL SHIBA FIRST,ند الشبا الأولى
1983,1733,1,7,NADD AL SHIBA FIRST,ند الشبا الأولى
1984,1733,0,7,NADD AL SHIBA FIRST,ند الشبا الأولى
1985,1733,1,8,NADD AL SHIBA FIRST,ند الشبا الأولى
1986,1733,1,9,NADD AL SHIBA FIRST,ند الشبا الأولى
1987,1733,0,9,NADD AL SHIBA FIRST,ند الشبا الأولى
1988,1733,2,11,NADD AL SHIBA FIRST,ند الشبا الأولى
1989,1733,3,14,NADD AL SHIBA FIRST,ند الشبا الأولى
1990,1733,0,14,NADD AL SHIBA FIRST,ند الشبا الأولى
1991,1733,1,15,NADD AL SHIBA FIRST,ند الشبا الأولى
1992,1733,0,15,NADD AL SHIBA FIRST,ند الشبا الأولى
1993,1733,3,18,NADD AL SHIBA FIRST,ند الشبا الأولى
1994,1733,1,19,NADD AL SHIBA FIRST,ند الشبا الأولى
1995,1733,2,21,NADD AL SHIBA FIRST,ند الشبا الأولى
1996,1733,0,21,NADD AL SHIBA FIRST,ند الشبا الأولى
1997,1733,2,23,NADD AL SHIBA FIRST,ند الشبا الأولى
1998,1733,0,23,NADD AL SHIBA FIRST,ند الشبا الأولى
1999,1733,3,26,NADD AL SHIBA FIRST,ند الشبا الأولى
2000,1733,6,32,NADD AL SHIBA FIRST,ند الشبا الأولى
2001,1733,6,38,NADD AL SHIBA FIRST,ند الشبا الأولى
2002,1733,4,42,NADD AL SHIBA FIRST,ند الشبا الأولى
2003,1733,4,46,NADD AL SHIBA FIRST,ند الشبا الأولى
2004,1733,7,53,NADD AL SHIBA FIRST,ند الشبا الأولى
2005,1733,6,59,NADD AL SHIBA FIRST,ند الشبا الأولى
2006,1733,6,65,NADD AL SHIBA FIRST,ند الشبا الأولى
2007,1733,9,74,NADD AL SHIBA FIRST,ند الشبا الأولى
2008,1733,8,82,NADD AL SHIBA FIRST,ند الشبا الأولى
2009,1733,5,87,NADD AL SHIBA FIRST,ند الشبا الأولى
2010,1733,13,100,NADD AL SHIBA FIRST,ند الشبا الأولى
2011,1733,16,116,NADD AL SHIBA FIRST,ند الشبا الأولى
2012,1733,17,133,NADD AL SHIBA FIRST,ند الشبا الأولى
2013,1733,14,147,NADD AL SHIBA FIRST,ند الشبا الأولى
2014,1733,13,160,NADD AL SHIBA FIRST,ند الشبا الأولى
2015,1733,22,182,NADD AL SHIBA FIRST,ند الشبا الأولى
2016,1733,23,205,NADD AL SHIBA FIRST,ند الشبا الأولى
2017,1733,20,225,NADD AL SHIBA FIRST,ند الشبا الأولى
2018,1733,25,250,NADD AL SHIBA FIRST,ند الشبا الأولى
2019,1733,42,292,NADD AL SHIBA FIRST,ند الشبا الأولى
2020,1733,75,367,NADD AL SHIBA FIRST,ند الشبا الأولى
2021,1733,0,367,NADD AL SHIBA FIRST,ند الشبا الأولى
1963,1853,0,0,RAS AL KHOR IND. FIRST,رأس الخور الصناعية الأولى
1964,1853,0,0,RAS AL KHOR IND. FIRST,رأس الخور الصناعية الأولى
1965,1853,0,0,RAS AL KHOR IND. FIRST,رأس الخور الصناعية الأولى
1966,1853,0,0,RAS AL KHOR IND. FIRST,رأس الخور الصناعية الأولى
1967,1853,0,0,RAS AL KHOR IND. FIRST,رأس الخور الصناعية الأولى
1968,1853,0,0,RAS AL KHOR IND. FIRST,رأس الخور الصناعية الأولى
1969,1853,0,0,RAS AL KHOR IND. FIRST,رأس الخور الصناعية الأولى
1970,1853,0,0,RAS AL KHOR IND. FIRST,رأس الخور الصناعية الأولى
1971,1853,0,0,RAS AL KHOR IND. FIRST,رأس الخور الصناعية الأولى
1972,1853,0,0,RAS AL KHOR IND. FIRST,رأس الخور الصناعية الأولى
1973,1853,0,0,RAS AL KHOR IND. FIRST,رأس الخور الصناعية الأولى
1974,1853,0,0,RAS AL KHOR IND. FIRST,رأس الخور الصناعية الأولى
1975,1853,1,1,RAS AL KHOR IND. FIRST,رأس الخور الصناعية الأولى
1976,1853,0,1,RAS AL KHOR IND. FIRST,رأس الخور الصناعية الأولى
1977,1853,0,1,RAS AL KHOR IND. FIRST,رأس الخور الصناعية الأولى
1978,1853,0,1,RAS AL KHOR IND. FIRST,رأس الخور الصناعية الأولى
1979,1853,0,1,RAS AL KHOR IND. FIRST,رأس الخور الصناعية الأولى
1980,1853,1,2,RAS AL KHOR IND. FIRST,رأس الخور الصناعية الأولى
1981,1853,0,2,RAS AL KHOR IND. FIRST,رأس الخور الصناعية الأولى
1982,1853,1,3,RAS AL KHOR IND. FIRST,رأس الخور الصناعية الأولى
1983,1853,0,3,RAS AL KHOR IND. FIRST,رأس الخور الصناعية الأولى
1984,1853,0,3,RAS AL KHOR IND. FIRST,رأس الخور الصناعية الأولى
1985,1853,0,3,RAS AL KHOR IND. FIRST,رأس الخور الصناعية الأولى
1986,1853,0,3,RAS AL KHOR IND. FIRST,رأس الخور الصناعية الأولى
1987,1853,0,3,RAS AL KHOR IND. FIRST,رأس الخور الصناعية الأولى
1988,1853,0,3,RAS AL KHOR IND. FIRST,رأس الخور الصناعية الأولى
1989,1853,0,3,RAS AL KHOR IND. FIRST,رأس الخور الصناعية الأولى
1990,1853,2,5,RAS AL KHOR IND. FIRST,رأس الخور الصناعية الأولى
1991,1853,0,5,RAS AL KHOR IND. FIRST,رأس الخور الصناعية الأولى
1992,1853,1,6,RAS AL KHOR IND. FIRST,رأس الخور الصناعية الأولى
1993,1853,1,7,RAS AL KHOR IND. FIRST,رأس الخور الصناعية الأولى
1994,1853,1,8,RAS AL KHOR IND. FIRST,رأس الخور الصناعية الأولى
1995,1853,0,8,RAS AL KHOR IND. FIRST,رأس الخور الصناعية الأولى
1996,1853,0,8,RAS AL KHOR IND. FIRST,رأس الخور الصناعية الأولى
1997,1853,1,9,RAS AL KHOR IND. FIRST,رأس الخور الصناعية الأولى
1998,1853,1,10,RAS AL KHOR IND. FIRST,رأس الخور الصناعية الأولى
1999,1853,1,11,RAS AL KHOR IND. FIRST,رأس الخور الصناعية الأولى
2000,1853,0,11,RAS AL KHOR IND. FIRST,رأس الخور الصناعية الأولى
2001,1853,0,11,RAS AL KHOR IND. FIRST,رأس الخور الصناعية الأولى
2002,1853,0,11,RAS AL KHOR IND. FIRST,رأس الخور الصناعية الأولى
2003,1853,2,13,RAS AL KHOR IND. FIRST,رأس الخور الصناعية الأولى
2004,1853,0,13,RAS AL KHOR IND. FIRST,رأس الخور الصناعية الأولى
2005,1853,1,14,RAS AL KHOR IND. FIRST,رأس الخور الصناعية الأولى
2006,1853,0,14,RAS AL KHOR IND. FIRST,رأس الخور الصناعية الأولى
2007,1853,2,16,RAS AL KHOR IND. FIRST,رأس الخور الصناعية الأولى
2008,1853,1,17,RAS AL KHOR IND. FIRST,رأس الخور الصناعية الأولى
2009,1853,1,18,RAS AL KHOR IND. FIRST,رأس الخور الصناعية الأولى
2010,1853,2,20,RAS AL KHOR IND. FIRST,رأس الخور الصناعية الأولى
2011,1853,3,23,RAS AL KHOR IND. FIRST,رأس الخور الصناعية الأولى
2012,1853,7,30,RAS AL KHOR IND. FIRST,رأس الخور الصناعية الأولى
2013,1853,3,33,RAS AL KHOR IND. FIRST,رأس الخور الصناعية الأولى
2014,1853,6,39,RAS AL KHOR IND. FIRST,رأس الخور الصناعية الأولى
2015,1853,7,46,RAS AL KHOR IND. FIRST,رأس الخور الصناعية الأولى
2016,1853,7,53,RAS AL KHOR IND. FIRST,رأس الخور الصناعية الأولى
2017,1853,4,57,RAS AL KHOR IND. FIRST,رأس الخور الصناعية الأولى
2018,1853,8,65,RAS AL KHOR IND. FIRST,رأس الخور الصناعية الأولى
2019,1853,9,74,RAS AL KHOR IND. FIRST,رأس الخور الصناعية الأولى
2020,1853,11,85,RAS AL KHOR IND. FIRST,رأس الخور الصناعية الأولى
2021,1853,0,85,RAS AL KHOR IND. FIRST,رأس الخور الصناعية الأولى
1963,1893,0,0,AL BARSHA SOUTH THIRD,البرشاء جنوب الثالثة
1964,1893,0,0,AL BARSHA SOUTH THIRD,البرشاء جنوب الثالثة
1965,1893,0,0,AL BARSHA SOUTH THIRD,البرشاء جنوب الثالثة
1966,1893,0,0,AL BARSHA SOUTH THIRD,البرشاء جنوب الثالثة
1967,1893,0,0,AL BARSHA SOUTH THIRD,البرشاء جنوب الثالثة
1968,1893,0,0,AL BARSHA SOUTH THIRD,البرشاء جنوب الثالثة
1969,1893,0,0,AL BARSHA SOUTH THIRD,البرشاء جنوب الثالثة
1970,1893,0,0,AL BARSHA SOUTH THIRD,البرشاء جنوب الثالثة
1971,1893,0,0,AL BARSHA SOUTH THIRD,البرشاء جنوب الثالثة
1972,1893,0,0,AL BARSHA SOUTH THIRD,البرشاء جنوب الثالثة
1973,1893,0,0,AL BARSHA SOUTH THIRD,البرشاء جنوب الثالثة
1974,1893,0,0,AL BARSHA SOUTH THIRD,البرشاء جنوب الثالثة
1975,1893,0,0,AL BARSHA SOUTH THIRD,البرشاء جنوب الثالثة
1976,1893,0,0,AL BARSHA SOUTH THIRD,البرشاء جنوب الثالثة
1977,1893,0,0,AL BARSHA SOUTH THIRD,البرشاء جنوب الثالثة
1978,1893,0,0,AL BARSHA SOUTH THIRD,البرشاء جنوب الثالثة
1979,1893,0,0,AL BARSHA SOUTH THIRD,البرشاء جنوب الثالثة
1980,1893,0,0,AL BARSHA SOUTH THIRD,البرشاء جنوب الثالثة
1981,1893,0,0,AL BARSHA SOUTH THIRD,البرشاء جنوب الثالثة
1982,1893,0,0,AL BARSHA SOUTH THIRD,البرشاء جنوب الثالثة
1983,1893,0,0,AL BARSHA SOUTH THIRD,البرشاء جنوب الثالثة
1984,1893,0,0,AL BARSHA SOUTH THIRD,البرشاء جنوب الثالثة
1985,1893,0,0,AL BARSHA SOUTH THIRD,البرشاء جنوب الثالثة
1986,1893,0,0,AL BARSHA SOUTH THIRD,البرشاء جنوب الثالثة
1987,1893,0,0,AL BARSHA SOUTH THIRD,البرشاء جنوب الثالثة
1988,1893,2,2,AL BARSHA SOUTH THIRD,البرشاء جنوب الثالثة
1989,1893,1,3,AL BARSHA SOUTH THIRD,البرشاء جنوب الثالثة
1990,1893,1,4,AL BARSHA SOUTH THIRD,البرشاء جنوب الثالثة
1991,1893,0,4,AL BARSHA SOUTH THIRD,البرشاء جنوب الثالثة
1992,1893,0,4,AL BARSHA SOUTH THIRD,البرشاء جنوب الثالثة
1993,1893,0,4,AL BARSHA SOUTH THIRD,البرشاء جنوب الثالثة
1994,1893,0,4,AL BARSHA SOUTH THIRD,البرشاء جنوب الثالثة
1995,1893,0,4,AL BARSHA SOUTH THIRD,البرشاء جنوب الثالثة
1996,1893,0,4,AL BARSHA SOUTH THIRD,البرشاء جنوب الثالثة
1997,1893,0,4,AL BARSHA SOUTH THIRD,البرشاء جنوب الثالثة
1998,1893,1,5,AL BARSHA SOUTH THIRD,البرشاء جنوب الثالثة
1999,1893,1,6,AL BARSHA SOUTH THIRD,البرشاء جنوب الثالثة
2000,1893,2,8,AL BARSHA SOUTH THIRD,البرشاء جنوب الثالثة
2001,1893,3,11,AL BARSHA SOUTH THIRD,البرشاء جنوب الثالثة
2002,1893,0,11,AL BARSHA SOUTH THIRD,البرشاء جنوب الثالثة
2003,1893,2,13,AL BARSHA SOUTH THIRD,البرشاء جنوب الثالثة
2004,1893,2,15,AL BARSHA SOUTH THIRD,البرشاء جنوب الثالثة
2005,1893,6,21,AL BARSHA SOUTH THIRD,البرشاء جنوب الثالثة
2006,1893,4,25,AL BARSHA SOUTH THIRD,البرشاء جنوب الثالثة
2007,1893,7,32,AL BARSHA SOUTH THIRD,البرشاء جنوب الثالثة
2008,1893,5,37,AL BARSHA SOUTH THIRD,البرشاء جنوب الثالثة
2009,1893,5,42,AL BARSHA SOUTH THIRD,البرشاء جنوب الثالثة
2010,1893,2,44,AL BARSHA SOUTH THIRD,البرشاء جنوب الثالثة
2011,1893,9,53,AL BARSHA SOUTH THIRD,البرشاء جنوب الثالثة
2012,1893,10,63,AL BARSHA SOUTH THIRD,البرشاء جنوب الثالثة
2013,1893,14,77,AL BARSHA SOUTH THIRD,البرشاء جنوب الثالثة
2014,1893,17,94,AL BARSHA SOUTH THIRD,البرشاء جنوب الثالثة
2015,1893,15,109,AL BARSHA SOUTH THIRD,البرشاء جنوب الثالثة
2016,1893,15,124,AL BARSHA SOUTH THIRD,البرشاء جنوب الثالثة
2017,1893,27,151,AL BARSHA SOUTH THIRD,البرشاء جنوب الثالثة
2018,1893,18,169,AL BARSHA SOUTH THIRD,البرشاء جنوب الثالثة
2019,1893,32,201,AL BARSHA SOUTH THIRD,البرشاء جنوب الثالثة
2020,1893,32,233,AL BARSHA SOUTH THIRD,البرشاء جنوب الثالثة
2021,1893,0,233,AL BARSHA SOUTH THIRD,البرشاء جنوب الثالثة
1963,1933,4,4,AL MURAR,المرر
1964,1933,1,5,AL MURAR,المرر
1965,1933,0,5,AL MURAR,المرر
1966,1933,0,5,AL MURAR,المرر
1967,1933,1,6,AL MURAR,المرر
1968,1933,0,6,AL MURAR,المرر
1969,1933,0,6,AL MURAR,المرر
1970,1933,1,7,AL MURAR,المرر
1971,1933,1,8,AL MURAR,المرر
1972,1933,1,9,AL MURAR,المرر
1973,1933,2,11,AL MURAR,المرر
1974,1933,3,14,AL MURAR,المرر
1975,1933,0,14,AL MURAR,المرر
1976,1933,3,17,AL MURAR,المرر
1977,1933,3,20,AL MURAR,المرر
1978,1933,1,21,AL MURAR,المرر
1979,1933,5,26,AL MURAR,المرر
1980,1933,5,31,AL MURAR,المرر
1981,1933,6,37,AL MURAR,المرر
1982,1933,7,44,AL MURAR,المرر
1983,1933,8,52,AL MURAR,المرر
1984,1933,5,57,AL MURAR,المرر
1985,1933,6,63,AL MURAR,المرر
1986,1933,7,70,AL MURAR,المرر
1987,1933,6,76,AL MURAR,المرر
1988,1933,12,88,AL MURAR,المرر
1989,1933,10,98,AL MURAR,المرر
1990,1933,10,108,AL MURAR,المرر
1991,1933,15,123,AL MURAR,المرر
1992,1933,18,141,AL MURAR,المرر
1993,1933,16,157,AL MURAR,المرر
1994,1933,16,173,AL MURAR,المرر
1995,1933,10,183,AL MURAR,المرر
1996,1933,17,200,AL MURAR,المرر
1997,1933,17,217,AL MURAR,المرر
1998,1933,26,243,AL MURAR,المرر
1999,1933,37,280,AL MURAR,المرر
2000,1933,35,315,AL MURAR,المرر
2001,1933,37,352,AL MURAR,المرر
2002,1933,73,425,AL MURAR,المرر
2003,1933,58,483,AL MURAR,المرر
2004,1933,68,551,AL MURAR,المرر
2005,1933,62,613,AL MURAR,المرر
2006,1933,85,698,AL MURAR,المرر
2007,1933,81,779,AL MURAR,المرر
2008,1933,110,889,AL MURAR,المرر
2009,1933,92,981,AL MURAR,المرر
2010,1933,113,1094,AL MURAR,المرر
2011,1933,144,1238,AL MURAR,المرر
2012,1933,190,1428,AL MURAR,المرر
2013,1933,167,1595,AL MURAR,المرر
2014,1933,226,1821,AL MURAR,المرر
2015,1933,182,2003,AL MURAR,المرر
2016,1933,172,2175,AL MURAR,المرر
2017,1933,196,2371,AL MURAR,المرر
2018,1933,220,2591,AL MURAR,المرر
2019,1933,306,2897,AL MURAR,المرر
2020,1933,490,3387,AL MURAR,المرر
2021,1933,0,3387,AL MURAR,المرر
1963,1973,0,0,AL SELAL,الصلال
1964,1973,0,0,AL SELAL,الصلال
1965,1973,0,0,AL SELAL,الصلال
1966,1973,0,0,AL SELAL,الصلال
1967,1973,0,0,AL SELAL,الصلال
1968,1973,0,0,AL SELAL,الصلال
1969,1973,0,0,AL SELAL,الصلال
1970,1973,0,0,AL SELAL,الصلال
1971,1973,0,0,AL SELAL,الصلال
1972,1973,0,0,AL SELAL,الصلال
1973,1973,0,0,AL SELAL,الصلال
1974,1973,0,0,AL SELAL,الصلال
1975,1973,0,0,AL SELAL,الصلال
1976,1973,0,0,AL SELAL,الصلال
1977,1973,0,0,AL SELAL,الصلال
1978,1973,0,0,AL SELAL,الصلال
1979,1973,0,0,AL SELAL,الصلال
1980,1973,0,0,AL SELAL,الصلال
1981,1973,0,0,AL SELAL,الصلال
1982,1973,0,0,AL SELAL,الصلال
1983,1973,0,0,AL SELAL,الصلال
1984,1973,0,0,AL SELAL,الصلال
1985,1973,0,0,AL SELAL,الصلال
1986,1973,0,0,AL SELAL,الصلال
1987,1973,0,0,AL SELAL,الصلال
1988,1973,0,0,AL SELAL,الصلال
1989,1973,0,0,AL SELAL,الصلال
1990,1973,0,0,AL SELAL,الصلال
1991,1973,0,0,AL SELAL,الصلال
1992,1973,0,0,AL SELAL,الصلال
1993,1973,0,0,AL SELAL,الصلال
1994,1973,0,0,AL SELAL,الصلال
1995,1973,0,0,AL SELAL,الصلال
1996,1973,0,0,AL SELAL,الصلال
1997,1973,0,0,AL SELAL,الصلال
1998,1973,0,0,AL SELAL,الصلال
1999,1973,0,0,AL SELAL,الصلال
2000,1973,0,0,AL SELAL,الصلال
2001,1973,0,0,AL SELAL,الصلال
2002,1973,0,0,AL SELAL,الصلال
2003,1973,0,0,AL SELAL,الصلال
2004,1973,0,0,AL SELAL,الصلال
2005,1973,0,0,AL SELAL,الصلال
2006,1973,0,0,AL SELAL,الصلال
2007,1973,0,0,AL SELAL,الصلال
2008,1973,0,0,AL SELAL,الصلال
2009,1973,0,0,AL SELAL,الصلال
2010,1973,0,0,AL SELAL,الصلال
2011,1973,0,0,AL SELAL,الصلال
2012,1973,1,1,AL SELAL,الصلال
2013,1973,1,2,AL SELAL,الصلال
2014,1973,0,2,AL SELAL,الصلال
2015,1973,0,2,AL SELAL,الصلال
2016,1973,0,2,AL SELAL,الصلال
2017,1973,0,2,AL SELAL,الصلال
2018,1973,2,4,AL SELAL,الصلال
2019,1973,1,5,AL SELAL,الصلال
2020,1973,11,16,AL SELAL,الصلال
2021,1973,0,16,AL SELAL,الصلال
1963,2013,0,0,AL YALAYIS 1,اليلايس 1
1964,2013,0,0,AL YALAYIS 1,اليلايس 1
1965,2013,0,0,AL YALAYIS 1,اليلايس 1
1966,2013,0,0,AL YALAYIS 1,اليلايس 1
1967,2013,0,0,AL YALAYIS 1,اليلايس 1
1968,2013,0,0,AL YALAYIS 1,اليلايس 1
1969,2013,0,0,AL YALAYIS 1,اليلايس 1
1970,2013,0,0,AL YALAYIS 1,اليلايس 1
1971,2013,0,0,AL YALAYIS 1,اليلايس 1
1972,2013,0,0,AL YALAYIS 1,اليلايس 1
1973,2013,0,0,AL YALAYIS 1,اليلايس 1
1974,2013,0,0,AL YALAYIS 1,اليلايس 1
1975,2013,0,0,AL YALAYIS 1,اليلايس 1
1976,2013,0,0,AL YALAYIS 1,اليلايس 1
1977,2013,0,0,AL YALAYIS 1,اليلايس 1
1978,2013,0,0,AL YALAYIS 1,اليلايس 1
1979,2013,0,0,AL YALAYIS 1,اليلايس 1
1980,2013,0,0,AL YALAYIS 1,اليلايس 1
1981,2013,0,0,AL YALAYIS 1,اليلايس 1
1982,2013,0,0,AL YALAYIS 1,اليلايس 1
1983,2013,0,0,AL YALAYIS 1,اليلايس 1
1984,2013,0,0,AL YALAYIS 1,اليلايس 1
1985,2013,0,0,AL YALAYIS 1,اليلايس 1
1986,2013,0,0,AL YALAYIS 1,اليلايس 1
1987,2013,0,0,AL YALAYIS 1,اليلايس 1
1988,2013,0,0,AL YALAYIS 1,اليلايس 1
1989,2013,0,0,AL YALAYIS 1,اليلايس 1
1990,2013,0,0,AL YALAYIS 1,اليلايس 1
1991,2013,0,0,AL YALAYIS 1,اليلايس 1
1992,2013,0,0,AL YALAYIS 1,اليلايس 1
1993,2013,0,0,AL YALAYIS 1,اليلايس 1
1994,2013,0,0,AL YALAYIS 1,اليلايس 1
1995,2013,0,0,AL YALAYIS 1,اليلايس 1
1996,2013,0,0,AL YALAYIS 1,اليلايس 1
1997,2013,0,0,AL YALAYIS 1,اليلايس 1
1998,2013,0,0,AL YALAYIS 1,اليلايس 1
1999,2013,0,0,AL YALAYIS 1,اليلايس 1
2000,2013,0,0,AL YALAYIS 1,اليلايس 1
2001,2013,0,0,AL YALAYIS 1,اليلايس 1
2002,2013,0,0,AL YALAYIS 1,اليلايس 1
2003,2013,0,0,AL YALAYIS 1,اليلايس 1
2004,2013,0,0,AL YALAYIS 1,اليلايس 1
2005,2013,0,0,AL YALAYIS 1,اليلايس 1
2006,2013,0,0,AL YALAYIS 1,اليلايس 1
2007,2013,1,1,AL YALAYIS 1,اليلايس 1
2008,2013,0,1,AL YALAYIS 1,اليلايس 1
2009,2013,0,1,AL YALAYIS 1,اليلايس 1
2010,2013,0,1,AL YALAYIS 1,اليلايس 1
2011,2013,0,1,AL YALAYIS 1,اليلايس 1
2012,2013,0,1,AL YALAYIS 1,اليلايس 1
2013,2013,0,1,AL YALAYIS 1,اليلايس 1
2014,2013,0,1,AL YALAYIS 1,اليلايس 1
2015,2013,1,2,AL YALAYIS 1,اليلايس 1
2016,2013,1,3,AL YALAYIS 1,اليلايس 1
2017,2013,0,3,AL YALAYIS 1,اليلايس 1
2018,2013,3,6,AL YALAYIS 1,اليلايس 1
2019,2013,9,15,AL YALAYIS 1,اليلايس 1
2020,2013,33,48,AL YALAYIS 1,اليلايس 1
2021,2013,0,48,AL YALAYIS 1,اليلايس 1
1963,2053,0,0,AL TWAR FIRST,الطوار الأولى
1964,2053,0,0,AL TWAR FIRST,الطوار الأولى
1965,2053,0,0,AL TWAR FIRST,الطوار الأولى
1966,2053,0,0,AL TWAR FIRST,الطوار الأولى
1967,2053,0,0,AL TWAR FIRST,الطوار الأولى
1968,2053,0,0,AL TWAR FIRST,الطوار الأولى
1969,2053,1,1,AL TWAR FIRST,الطوار الأولى
1970,2053,0,1,AL TWAR FIRST,الطوار الأولى
1971,2053,0,1,AL TWAR FIRST,الطوار الأولى
1972,2053,0,1,AL TWAR FIRST,الطوار الأولى
1973,2053,0,1,AL TWAR FIRST,الطوار الأولى
1974,2053,0,1,AL TWAR FIRST,الطوار الأولى
1975,2053,0,1,AL TWAR FIRST,الطوار الأولى
1976,2053,0,1,AL TWAR FIRST,الطوار الأولى
1977,2053,1,2,AL TWAR FIRST,الطوار الأولى
1978,2053,1,3,AL TWAR FIRST,الطوار الأولى
1979,2053,0,3,AL TWAR FIRST,الطوار الأولى
1980,2053,0,3,AL TWAR FIRST,الطوار الأولى
1981,2053,1,4,AL TWAR FIRST,الطوار الأولى
1982,2053,1,5,AL TWAR FIRST,الطوار الأولى
1983,2053,1,6,AL TWAR FIRST,الطوار الأولى
1984,2053,0,6,AL TWAR FIRST,الطوار الأولى
1985,2053,0,6,AL TWAR FIRST,الطوار الأولى
1986,2053,3,9,AL TWAR FIRST,الطوار الأولى
1987,2053,1,10,AL TWAR FIRST,الطوار الأولى
1988,2053,2,12,AL TWAR FIRST,الطوار الأولى
1989,2053,1,13,AL TWAR FIRST,الطوار الأولى
1990,2053,1,14,AL TWAR FIRST,الطوار الأولى
1991,2053,2,16,AL TWAR FIRST,الطوار الأولى
1992,2053,2,18,AL TWAR FIRST,الطوار الأولى
1993,2053,0,18,AL TWAR FIRST,الطوار الأولى
1994,2053,5,23,AL TWAR FIRST,الطوار الأولى
1995,2053,1,24,AL TWAR FIRST,الطوار الأولى
1996,2053,1,25,AL TWAR FIRST,الطوار الأولى
1997,2053,6,31,AL TWAR FIRST,الطوار الأولى
1998,2053,2,33,AL TWAR FIRST,الطوار الأولى
1999,2053,5,38,AL TWAR FIRST,الطوار الأولى
2000,2053,2,40,AL TWAR FIRST,الطوار الأولى
2001,2053,3,43,AL TWAR FIRST,الطوار الأولى
2002,2053,2,45,AL TWAR FIRST,الطوار الأولى
2003,2053,4,49,AL TWAR FIRST,الطوار الأولى
2004,2053,4,53,AL TWAR FIRST,الطوار الأولى
2005,2053,3,56,AL TWAR FIRST,الطوار الأولى
2006,2053,3,59,AL TWAR FIRST,الطوار الأولى
2007,2053,3,62,AL TWAR FIRST,الطوار الأولى
2008,2053,3,65,AL TWAR FIRST,الطوار الأولى
2009,2053,8,73,AL TWAR FIRST,الطوار الأولى
2010,2053,2,75,AL TWAR FIRST,الطوار الأولى
2011,2053,5,80,AL TWAR FIRST,الطوار الأولى
2012,2053,7,87,AL TWAR FIRST,الطوار الأولى
2013,2053,4,91,AL TWAR FIRST,الطوار الأولى
2014,2053,3,94,AL TWAR FIRST,الطوار الأولى
2015,2053,5,99,AL TWAR FIRST,الطوار الأولى
2016,2053,3,102,AL TWAR FIRST,الطوار الأولى
2017,2053,3,105,AL TWAR FIRST,الطوار الأولى
2018,2053,6,111,AL TWAR FIRST,الطوار الأولى
2019,2053,9,120,AL TWAR FIRST,الطوار الأولى
2020,2053,35,155,AL TWAR FIRST,الطوار الأولى
2021,2053,0,155,AL TWAR FIRST,الطوار الأولى
1963,2133,0,0,AL TWAR THIRD,الطوار الثالثة
1964,2133,0,0,AL TWAR THIRD,الطوار الثالثة
1965,2133,0,0,AL TWAR THIRD,الطوار الثالثة
1966,2133,0,0,AL TWAR THIRD,الطوار الثالثة
1967,2133,0,0,AL TWAR THIRD,الطوار الثالثة
1968,2133,0,0,AL TWAR THIRD,الطوار الثالثة
1969,2133,0,0,AL TWAR THIRD,الطوار الثالثة
1970,2133,0,0,AL TWAR THIRD,الطوار الثالثة
1971,2133,0,0,AL TWAR THIRD,الطوار الثالثة
1972,2133,0,0,AL TWAR THIRD,الطوار الثالثة
1973,2133,0,0,AL TWAR THIRD,الطوار الثالثة
1974,2133,0,0,AL TWAR THIRD,الطوار الثالثة
1975,2133,0,0,AL TWAR THIRD,الطوار الثالثة
1976,2133,0,0,AL TWAR THIRD,الطوار الثالثة
1977,2133,0,0,AL TWAR THIRD,الطوار الثالثة
1978,2133,0,0,AL TWAR THIRD,الطوار الثالثة
1979,2133,1,1,AL TWAR THIRD,الطوار الثالثة
1980,2133,0,1,AL TWAR THIRD,الطوار الثالثة
1981,2133,0,1,AL TWAR THIRD,الطوار الثالثة
1982,2133,0,1,AL TWAR THIRD,الطوار الثالثة
1983,2133,1,2,AL TWAR THIRD,الطوار الثالثة
1984,2133,0,2,AL TWAR THIRD,الطوار الثالثة
1985,2133,0,2,AL TWAR THIRD,الطوار الثالثة
1986,2133,0,2,AL TWAR THIRD,الطوار الثالثة
1987,2133,0,2,AL TWAR THIRD,الطوار الثالثة
1988,2133,0,2,AL TWAR THIRD,الطوار الثالثة
1989,2133,0,2,AL TWAR THIRD,الطوار الثالثة
1990,2133,2,4,AL TWAR THIRD,الطوار الثالثة
1991,2133,0,4,AL TWAR THIRD,الطوار الثالثة
1992,2133,0,4,AL TWAR THIRD,الطوار الثالثة
1993,2133,0,4,AL TWAR THIRD,الطوار الثالثة
1994,2133,1,5,AL TWAR THIRD,الطوار الثالثة
1995,2133,0,5,AL TWAR THIRD,الطوار الثالثة
1996,2133,1,6,AL TWAR THIRD,الطوار الثالثة
1997,2133,0,6,AL TWAR THIRD,الطوار الثالثة
1998,2133,1,7,AL TWAR THIRD,الطوار الثالثة
1999,2133,0,7,AL TWAR THIRD,الطوار الثالثة
2000,2133,1,8,AL TWAR THIRD,الطوار الثالثة
2001,2133,0,8,AL TWAR THIRD,الطوار الثالثة
2002,2133,0,8,AL TWAR THIRD,الطوار الثالثة
2003,2133,0,8,AL TWAR THIRD,الطوار الثالثة
2004,2133,0,8,AL TWAR THIRD,الطوار الثالثة
2005,2133,0,8,AL TWAR THIRD,الطوار الثالثة
2006,2133,0,8,AL TWAR THIRD,الطوار الثالثة
2007,2133,3,11,AL TWAR THIRD,الطوار الثالثة
2008,2133,1,12,AL TWAR THIRD,الطوار الثالثة
2009,2133,0,12,AL TWAR THIRD,الطوار الثالثة
2010,2133,2,14,AL TWAR THIRD,الطوار الثالثة
2011,2133,0,14,AL TWAR THIRD,الطوار الثالثة
2012,2133,2,16,AL TWAR THIRD,الطوار الثالثة
2013,2133,2,18,AL TWAR THIRD,الطوار الثالثة
2014,2133,2,20,AL TWAR THIRD,الطوار الثالثة
2015,2133,7,27,AL TWAR THIRD,الطوار الثالثة
2016,2133,2,29,AL TWAR THIRD,الطوار الثالثة
2017,2133,4,33,AL TWAR THIRD,الطوار الثالثة
2018,2133,4,37,AL TWAR THIRD,الطوار الثالثة
2019,2133,16,53,AL TWAR THIRD,الطوار الثالثة
2020,2133,52,105,AL TWAR THIRD,الطوار الثالثة
2021,2133,0,105,AL TWAR THIRD,الطوار الثالثة
1963,2173,0,0,AL SAFOUH FIRST,الصفوح الأولى
1964,2173,0,0,AL SAFOUH FIRST,الصفوح الأولى
1965,2173,0,0,AL SAFOUH FIRST,الصفوح الأولى
1966,2173,0,0,AL SAFOUH FIRST,الصفوح الأولى
1967,2173,0,0,AL SAFOUH FIRST,الصفوح الأولى
1968,2173,0,0,AL SAFOUH FIRST,الصفوح الأولى
1969,2173,0,0,AL SAFOUH FIRST,الصفوح الأولى
1970,2173,0,0,AL SAFOUH FIRST,الصفوح الأولى
1971,2173,0,0,AL SAFOUH FIRST,الصفوح الأولى
1972,2173,0,0,AL SAFOUH FIRST,الصفوح الأولى
1973,2173,0,0,AL SAFOUH FIRST,الصفوح الأولى
1974,2173,0,0,AL SAFOUH FIRST,الصفوح الأولى
1975,2173,0,0,AL SAFOUH FIRST,الصفوح الأولى
1976,2173,0,0,AL SAFOUH FIRST,الصفوح الأولى
1977,2173,0,0,AL SAFOUH FIRST,الصفوح الأولى
1978,2173,0,0,AL SAFOUH FIRST,الصفوح الأولى
1979,2173,0,0,AL SAFOUH FIRST,الصفوح الأولى
1980,2173,0,0,AL SAFOUH FIRST,الصفوح الأولى
1981,2173,0,0,AL SAFOUH FIRST,الصفوح الأولى
1982,2173,0,0,AL SAFOUH FIRST,الصفوح الأولى
1983,2173,0,0,AL SAFOUH FIRST,الصفوح الأولى
1984,2173,0,0,AL SAFOUH FIRST,الصفوح الأولى
1985,2173,0,0,AL SAFOUH FIRST,الصفوح الأولى
1986,2173,0,0,AL SAFOUH FIRST,الصفوح الأولى
1987,2173,0,0,AL SAFOUH FIRST,الصفوح الأولى
1988,2173,0,0,AL SAFOUH FIRST,الصفوح الأولى
1989,2173,0,0,AL SAFOUH FIRST,الصفوح الأولى
1990,2173,0,0,AL SAFOUH FIRST,الصفوح الأولى
1991,2173,0,0,AL SAFOUH FIRST,الصفوح الأولى
1992,2173,0,0,AL SAFOUH FIRST,الصفوح الأولى
1993,2173,1,1,AL SAFOUH FIRST,الصفوح الأولى
1994,2173,0,1,AL SAFOUH FIRST,الصفوح الأولى
1995,2173,0,1,AL SAFOUH FIRST,الصفوح الأولى
1996,2173,0,1,AL SAFOUH FIRST,الصفوح الأولى
1997,2173,1,2,AL SAFOUH FIRST,الصفوح الأولى
1998,2173,1,3,AL SAFOUH FIRST,الصفوح الأولى
1999,2173,3,6,AL SAFOUH FIRST,الصفوح الأولى
2000,2173,1,7,AL SAFOUH FIRST,الصفوح الأولى
2001,2173,2,9,AL SAFOUH FIRST,الصفوح الأولى
2002,2173,1,10,AL SAFOUH FIRST,الصفوح الأولى
2003,2173,1,11,AL SAFOUH FIRST,الصفوح الأولى
2004,2173,8,19,AL SAFOUH FIRST,الصفوح الأولى
2005,2173,4,23,AL SAFOUH FIRST,الصفوح الأولى
2006,2173,6,29,AL SAFOUH FIRST,الصفوح الأولى
2007,2173,4,33,AL SAFOUH FIRST,الصفوح الأولى
2008,2173,6,39,AL SAFOUH FIRST,الصفوح الأولى
2009,2173,7,46,AL SAFOUH FIRST,الصفوح الأولى
2010,2173,6,52,AL SAFOUH FIRST,الصفوح الأولى
2011,2173,11,63,AL SAFOUH FIRST,الصفوح الأولى
2012,2173,14,77,AL SAFOUH FIRST,الصفوح الأولى
2013,2173,11,88,AL SAFOUH FIRST,الصفوح الأولى
2014,2173,18,106,AL SAFOUH FIRST,الصفوح الأولى
2015,2173,14,120,AL SAFOUH FIRST,الصفوح الأولى
2016,2173,18,138,AL SAFOUH FIRST,الصفوح الأولى
2017,2173,21,159,AL SAFOUH FIRST,الصفوح الأولى
2018,2173,22,181,AL SAFOUH FIRST,الصفوح الأولى
2019,2173,32,213,AL SAFOUH FIRST,الصفوح الأولى
2020,2173,49,262,AL SAFOUH FIRST,الصفوح الأولى
2021,2173,0,262,AL SAFOUH FIRST,الصفوح الأولى
1963,2253,0,0,MUHAISNAH FIRST,محيصنة الأولى
1964,2253,1,1,MUHAISNAH FIRST,محيصنة الأولى
1965,2253,0,1,MUHAISNAH FIRST,محيصنة الأولى
1966,2253,0,1,MUHAISNAH FIRST,محيصنة الأولى
1967,2253,0,1,MUHAISNAH FIRST,محيصنة الأولى
1968,2253,0,1,MUHAISNAH FIRST,محيصنة الأولى
1969,2253,0,1,MUHAISNAH FIRST,محيصنة الأولى
1970,2253,0,1,MUHAISNAH FIRST,محيصنة الأولى
1971,2253,0,1,MUHAISNAH FIRST,محيصنة الأولى
1972,2253,0,1,MUHAISNAH FIRST,محيصنة الأولى
1973,2253,0,1,MUHAISNAH FIRST,محيصنة الأولى
1974,2253,0,1,MUHAISNAH FIRST,محيصنة الأولى
1975,2253,1,2,MUHAISNAH FIRST,محيصنة الأولى
1976,2253,1,3,MUHAISNAH FIRST,محيصنة الأولى
1977,2253,0,3,MUHAISNAH FIRST,محيصنة الأولى
1978,2253,0,3,MUHAISNAH FIRST,محيصنة الأولى
1979,2253,0,3,MUHAISNAH FIRST,محيصنة الأولى
1980,2253,0,3,MUHAISNAH FIRST,محيصنة الأولى
1981,2253,0,3,MUHAISNAH FIRST,محيصنة الأولى
1982,2253,0,3,MUHAISNAH FIRST,محيصنة الأولى
1983,2253,2,5,MUHAISNAH FIRST,محيصنة الأولى
1984,2253,0,5,MUHAISNAH FIRST,محيصنة الأولى
1985,2253,1,6,MUHAISNAH FIRST,محيصنة الأولى
1986,2253,0,6,MUHAISNAH FIRST,محيصنة الأولى
1987,2253,1,7,MUHAISNAH FIRST,محيصنة الأولى
1988,2253,3,10,MUHAISNAH FIRST,محيصنة الأولى
1989,2253,1,11,MUHAISNAH FIRST,محيصنة الأولى
1990,2253,0,11,MUHAISNAH FIRST,محيصنة الأولى
1991,2253,1,12,MUHAISNAH FIRST,محيصنة الأولى
1992,2253,0,12,MUHAISNAH FIRST,محيصنة الأولى
1993,2253,0,12,MUHAISNAH FIRST,محيصنة الأولى
1994,2253,2,14,MUHAISNAH FIRST,محيصنة الأولى
1995,2253,0,14,MUHAISNAH FIRST,محيصنة الأولى
1996,2253,0,14,MUHAISNAH FIRST,محيصنة الأولى
1997,2253,1,15,MUHAISNAH FIRST,محيصنة الأولى
1998,2253,3,18,MUHAISNAH FIRST,محيصنة الأولى
1999,2253,2,20,MUHAISNAH FIRST,محيصنة الأولى
2000,2253,0,20,MUHAISNAH FIRST,محيصنة الأولى
2001,2253,0,20,MUHAISNAH FIRST,محيصنة الأولى
2002,2253,5,25,MUHAISNAH FIRST,محيصنة الأولى
2003,2253,6,31,MUHAISNAH FIRST,محيصنة الأولى
2004,2253,3,34,MUHAISNAH FIRST,محيصنة الأولى
2005,2253,2,36,MUHAISNAH FIRST,محيصنة الأولى
2006,2253,9,45,MUHAISNAH FIRST,محيصنة الأولى
2007,2253,2,47,MUHAISNAH FIRST,محيصنة الأولى
2008,2253,6,53,MUHAISNAH FIRST,محيصنة الأولى
2009,2253,7,60,MUHAISNAH FIRST,محيصنة الأولى
2010,2253,21,81,MUHAISNAH FIRST,محيصنة الأولى
2011,2253,10,91,MUHAISNAH FIRST,محيصنة الأولى
2012,2253,10,101,MUHAISNAH FIRST,محيصنة الأولى
2013,2253,8,109,MUHAISNAH FIRST,محيصنة الأولى
2014,2253,9,118,MUHAISNAH FIRST,محيصنة الأولى
2015,2253,7,125,MUHAISNAH FIRST,محيصنة الأولى
2016,2253,5,130,MUHAISNAH FIRST,محيصنة الأولى
2017,2253,9,139,MUHAISNAH FIRST,محيصنة الأولى
2018,2253,17,156,MUHAISNAH FIRST,محيصنة الأولى
2019,2253,20,176,MUHAISNAH FIRST,محيصنة الأولى
2020,2253,67,243,MUHAISNAH FIRST,محيصنة الأولى
2021,2253,0,243,MUHAISNAH FIRST,محيصنة الأولى
1963,2293,0,0,MUSHRAIF,مشرف
1964,2293,0,0,MUSHRAIF,مشرف
1965,2293,0,0,MUSHRAIF,مشرف
1966,2293,0,0,MUSHRAIF,مشرف
1967,2293,0,0,MUSHRAIF,مشرف
1968,2293,0,0,MUSHRAIF,مشرف
1969,2293,0,0,MUSHRAIF,مشرف
1970,2293,0,0,MUSHRAIF,مشرف
1971,2293,0,0,MUSHRAIF,مشرف
1972,2293,0,0,MUSHRAIF,مشرف
1973,2293,0,0,MUSHRAIF,مشرف
1974,2293,0,0,MUSHRAIF,مشرف
1975,2293,0,0,MUSHRAIF,مشرف
1976,2293,0,0,MUSHRAIF,مشرف
1977,2293,0,0,MUSHRAIF,مشرف
1978,2293,0,0,MUSHRAIF,مشرف
1979,2293,0,0,MUSHRAIF,مشرف
1980,2293,0,0,MUSHRAIF,مشرف
1981,2293,0,0,MUSHRAIF,مشرف
1982,2293,0,0,MUSHRAIF,مشرف
1983,2293,1,1,MUSHRAIF,مشرف
1984,2293,0,1,MUSHRAIF,مشرف
1985,2293,0,1,MUSHRAIF,مشرف
1986,2293,0,1,MUSHRAIF,مشرف
1987,2293,0,1,MUSHRAIF,مشرف
1988,2293,0,1,MUSHRAIF,مشرف
1989,2293,0,1,MUSHRAIF,مشرف
1990,2293,0,1,MUSHRAIF,مشرف
1991,2293,0,1,MUSHRAIF,مشرف
1992,2293,0,1,MUSHRAIF,مشرف
1993,2293,0,1,MUSHRAIF,مشرف
1994,2293,0,1,MUSHRAIF,مشرف
1995,2293,0,1,MUSHRAIF,مشرف
1996,2293,0,1,MUSHRAIF,مشرف
1997,2293,0,1,MUSHRAIF,مشرف
1998,2293,0,1,MUSHRAIF,مشرف
1999,2293,0,1,MUSHRAIF,مشرف
2000,2293,1,2,MUSHRAIF,مشرف
2001,2293,3,5,MUSHRAIF,مشرف
2002,2293,0,5,MUSHRAIF,مشرف
2003,2293,0,5,MUSHRAIF,مشرف
2004,2293,0,5,MUSHRAIF,مشرف
2005,2293,0,5,MUSHRAIF,مشرف
2006,2293,0,5,MUSHRAIF,مشرف
2007,2293,0,5,MUSHRAIF,مشرف
2008,2293,0,5,MUSHRAIF,مشرف
2009,2293,0,5,MUSHRAIF,مشرف
2010,2293,1,6,MUSHRAIF,مشرف
2011,2293,0,6,MUSHRAIF,مشرف
2012,2293,1,7,MUSHRAIF,مشرف
2013,2293,0,7,MUSHRAIF,مشرف
2014,2293,0,7,MUSHRAIF,مشرف
2015,2293,1,8,MUSHRAIF,مشرف
2016,2293,0,8,MUSHRAIF,مشرف
2017,2293,1,9,MUSHRAIF,مشرف
2018,2293,0,9,MUSHRAIF,مشرف
2019,2293,0,9,MUSHRAIF,مشرف
2020,2293,5,14,MUSHRAIF,مشرف
2021,2293,0,14,MUSHRAIF,مشرف
1963,2333,0,0,AL HAMRIYA,الحمرية
1964,2333,0,0,AL HAMRIYA,الحمرية
1965,2333,0,0,AL HAMRIYA,الحمرية
1966,2333,0,0,AL HAMRIYA,الحمرية
1967,2333,0,0,AL HAMRIYA,الحمرية
1968,2333,1,1,AL HAMRIYA,الحمرية
1969,2333,0,1,AL HAMRIYA,الحمرية
1970,2333,1,2,AL HAMRIYA,الحمرية
1971,2333,1,3,AL HAMRIYA,الحمرية
1972,2333,1,4,AL HAMRIYA,الحمرية
1973,2333,0,4,AL HAMRIYA,الحمرية
1974,2333,0,4,AL HAMRIYA,الحمرية
1975,2333,0,4,AL HAMRIYA,الحمرية
1976,2333,1,5,AL HAMRIYA,الحمرية
1977,2333,1,6,AL HAMRIYA,الحمرية
1978,2333,0,6,AL HAMRIYA,الحمرية
1979,2333,1,7,AL HAMRIYA,الحمرية
1980,2333,2,9,AL HAMRIYA,الحمرية
1981,2333,2,11,AL HAMRIYA,الحمرية
1982,2333,1,12,AL HAMRIYA,الحمرية
1983,2333,0,12,AL HAMRIYA,الحمرية
1984,2333,0,12,AL HAMRIYA,الحمرية
1985,2333,0,12,AL HAMRIYA,الحمرية
1986,2333,1,13,AL HAMRIYA,الحمرية
1987,2333,3,16,AL HAMRIYA,الحمرية
1988,2333,3,19,AL HAMRIYA,الحمرية
1989,2333,3,22,AL HAMRIYA,الحمرية
1990,2333,3,25,AL HAMRIYA,الحمرية
1991,2333,1,26,AL HAMRIYA,الحمرية
1992,2333,2,28,AL HAMRIYA,الحمرية
1993,2333,2,30,AL HAMRIYA,الحمرية
1994,2333,4,34,AL HAMRIYA,الحمرية
1995,2333,3,37,AL HAMRIYA,الحمرية
1996,2333,2,39,AL HAMRIYA,الحمرية
1997,2333,5,44,AL HAMRIYA,الحمرية
1998,2333,4,48,AL HAMRIYA,الحمرية
1999,2333,5,53,AL HAMRIYA,الحمرية
2000,2333,4,57,AL HAMRIYA,الحمرية
2001,2333,6,63,AL HAMRIYA,الحمرية
2002,2333,9,72,AL HAMRIYA,الحمرية
2003,2333,3,75,AL HAMRIYA,الحمرية
2004,2333,5,80,AL HAMRIYA,الحمرية
2005,2333,10,90,AL HAMRIYA,الحمرية
2006,2333,7,97,AL HAMRIYA,الحمرية
2007,2333,7,104,AL HAMRIYA,الحمرية
2008,2333,9,113,AL HAMRIYA,الحمرية
2009,2333,6,119,AL HAMRIYA,الحمرية
2010,2333,5,124,AL HAMRIYA,الحمرية
2011,2333,6,130,AL HAMRIYA,الحمرية
2012,2333,5,135,AL HAMRIYA,الحمرية
2013,2333,15,150,AL HAMRIYA,الحمرية
2014,2333,20,170,AL HAMRIYA,الحمرية
2015,2333,16,186,AL HAMRIYA,الحمرية
2016,2333,19,205,AL HAMRIYA,الحمرية
2017,2333,31,236,AL HAMRIYA,الحمرية
2018,2333,41,277,AL HAMRIYA,الحمرية
2019,2333,32,309,AL HAMRIYA,الحمرية
2020,2333,59,368,AL HAMRIYA,الحمرية
2021,2333,0,368,AL HAMRIYA,الحمرية
1963,2373,0,0,AL HEBIAH FIFTH,الحبيه الخامسة
1964,2373,0,0,AL HEBIAH FIFTH,الحبيه الخامسة
1965,2373,0,0,AL HEBIAH FIFTH,الحبيه الخامسة
1966,2373,0,0,AL HEBIAH FIFTH,الحبيه الخامسة
1967,2373,0,0,AL HEBIAH FIFTH,الحبيه الخامسة
1968,2373,0,0,AL HEBIAH FIFTH,الحبيه الخامسة
1969,2373,0,0,AL HEBIAH FIFTH,الحبيه الخامسة
1970,2373,0,0,AL HEBIAH FIFTH,الحبيه الخامسة
1971,2373,0,0,AL HEBIAH FIFTH,الحبيه الخامسة
1972,2373,0,0,AL HEBIAH FIFTH,الحبيه الخامسة
1973,2373,0,0,AL HEBIAH FIFTH,الحبيه الخامسة
1974,2373,0,0,AL HEBIAH FIFTH,الحبيه الخامسة
1975,2373,0,0,AL HEBIAH FIFTH,الحبيه الخامسة
1976,2373,0,0,AL HEBIAH FIFTH,الحبيه الخامسة
1977,2373,0,0,AL HEBIAH FIFTH,الحبيه الخامسة
1978,2373,0,0,AL HEBIAH FIFTH,الحبيه الخامسة
1979,2373,0,0,AL HEBIAH FIFTH,الحبيه الخامسة
1980,2373,0,0,AL HEBIAH FIFTH,الحبيه الخامسة
1981,2373,0,0,AL HEBIAH FIFTH,الحبيه الخامسة
1982,2373,0,0,AL HEBIAH FIFTH,الحبيه الخامسة
1983,2373,0,0,AL HEBIAH FIFTH,الحبيه الخامسة
1984,2373,0,0,AL HEBIAH FIFTH,الحبيه الخامسة
1985,2373,0,0,AL HEBIAH FIFTH,الحبيه الخامسة
1986,2373,0,0,AL HEBIAH FIFTH,الحبيه الخامسة
1987,2373,0,0,AL HEBIAH FIFTH,الحبيه الخامسة
1988,2373,0,0,AL HEBIAH FIFTH,الحبيه الخامسة
1989,2373,0,0,AL HEBIAH FIFTH,الحبيه الخامسة
1990,2373,0,0,AL HEBIAH FIFTH,الحبيه الخامسة
1991,2373,0,0,AL HEBIAH FIFTH,الحبيه الخامسة
1992,2373,0,0,AL HEBIAH FIFTH,الحبيه الخامسة
1993,2373,0,0,AL HEBIAH FIFTH,الحبيه الخامسة
1994,2373,0,0,AL HEBIAH FIFTH,الحبيه الخامسة
1995,2373,0,0,AL HEBIAH FIFTH,الحبيه الخامسة
1996,2373,0,0,AL HEBIAH FIFTH,الحبيه الخامسة
1997,2373,0,0,AL HEBIAH FIFTH,الحبيه الخامسة
1998,2373,0,0,AL HEBIAH FIFTH,الحبيه الخامسة
1999,2373,0,0,AL HEBIAH FIFTH,الحبيه الخامسة
2000,2373,0,0,AL HEBIAH FIFTH,الحبيه الخامسة
2001,2373,0,0,AL HEBIAH FIFTH,الحبيه الخامسة
2002,2373,0,0,AL HEBIAH FIFTH,الحبيه الخامسة
2003,2373,0,0,AL HEBIAH FIFTH,الحبيه الخامسة
2004,2373,0,0,AL HEBIAH FIFTH,الحبيه الخامسة
2005,2373,0,0,AL HEBIAH FIFTH,الحبيه الخامسة
2006,2373,0,0,AL HEBIAH FIFTH,الحبيه الخامسة
2007,2373,0,0,AL HEBIAH FIFTH,الحبيه الخامسة
2008,2373,0,0,AL HEBIAH FIFTH,الحبيه الخامسة
2009,2373,1,1,AL HEBIAH FIFTH,الحبيه الخامسة
2010,2373,0,1,AL HEBIAH FIFTH,الحبيه الخامسة
2011,2373,0,1,AL HEBIAH FIFTH,الحبيه الخامسة
2012,2373,0,1,AL HEBIAH FIFTH,الحبيه الخامسة
2013,2373,4,5,AL HEBIAH FIFTH,الحبيه الخامسة
2014,2373,0,5,AL HEBIAH FIFTH,الحبيه الخامسة
2015,2373,2,7,AL HEBIAH FIFTH,الحبيه الخامسة
2016,2373,0,7,AL HEBIAH FIFTH,الحبيه الخامسة
2017,2373,1,8,AL HEBIAH FIFTH,الحبيه الخامسة
2018,2373,1,9,AL HEBIAH FIFTH,الحبيه الخامسة
2019,2373,11,20,AL HEBIAH FIFTH,الحبيه الخامسة
2020,2373,16,36,AL HEBIAH FIFTH,الحبيه الخامسة
2021,2373,0,36,AL HEBIAH FIFTH,الحبيه الخامسة
1963,2453,0,0,ABU HAIL,أبو هيل
1964,2453,0,0,ABU HAIL,أبو هيل
1965,2453,0,0,ABU HAIL,أبو هيل
1966,2453,0,0,ABU HAIL,أبو هيل
1967,2453,0,0,ABU HAIL,أبو هيل
1968,2453,0,0,ABU HAIL,أبو هيل
1969,2453,0,0,ABU HAIL,أبو هيل
1970,2453,1,1,ABU HAIL,أبو هيل
1971,2453,1,2,ABU HAIL,أبو هيل
1972,2453,0,2,ABU HAIL,أبو هيل
1973,2453,0,2,ABU HAIL,أبو هيل
1974,2453,1,3,ABU HAIL,أبو هيل
1975,2453,1,4,ABU HAIL,أبو هيل
1976,2453,0,4,ABU HAIL,أبو هيل
1977,2453,0,4,ABU HAIL,أبو هيل
1978,2453,0,4,ABU HAIL,أبو هيل
1979,2453,0,4,ABU HAIL,أبو هيل
1980,2453,0,4,ABU HAIL,أبو هيل
1981,2453,1,5,ABU HAIL,أبو هيل
1982,2453,2,7,ABU HAIL,أبو هيل
1983,2453,0,7,ABU HAIL,أبو هيل
1984,2453,0,7,ABU HAIL,أبو هيل
1985,2453,0,7,ABU HAIL,أبو هيل
1986,2453,0,7,ABU HAIL,أبو هيل
1987,2453,0,7,ABU HAIL,أبو هيل
1988,2453,0,7,ABU HAIL,أبو هيل
1989,2453,0,7,ABU HAIL,أبو هيل
1990,2453,3,10,ABU HAIL,أبو هيل
1991,2453,1,11,ABU HAIL,أبو هيل
1992,2453,1,12,ABU HAIL,أبو هيل
1993,2453,0,12,ABU HAIL,أبو هيل
1994,2453,5,17,ABU HAIL,أبو هيل
1995,2453,0,17,ABU HAIL,أبو هيل
1996,2453,1,18,ABU HAIL,أبو هيل
1997,2453,1,19,ABU HAIL,أبو هيل
1998,2453,2,21,ABU HAIL,أبو هيل
1999,2453,3,24,ABU HAIL,أبو هيل
2000,2453,3,27,ABU HAIL,أبو هيل
2001,2453,0,27,ABU HAIL,أبو هيل
2002,2453,2,29,ABU HAIL,أبو هيل
2003,2453,3,32,ABU HAIL,أبو هيل
2004,2453,2,34,ABU HAIL,أبو هيل
2005,2453,2,36,ABU HAIL,أبو هيل
2006,2453,1,37,ABU HAIL,أبو هيل
2007,2453,4,41,ABU HAIL,أبو هيل
2008,2453,1,42,ABU HAIL,أبو هيل
2009,2453,2,44,ABU HAIL,أبو هيل
2010,2453,2,46,ABU HAIL,أبو هيل
2011,2453,4,50,ABU HAIL,أبو هيل
2012,2453,3,53,ABU HAIL,أبو هيل
2013,2453,4,57,ABU HAIL,أبو هيل
2014,2453,1,58,ABU HAIL,أبو هيل
2015,2453,2,60,ABU HAIL,أبو هيل
2016,2453,2,62,ABU HAIL,أبو هيل
2017,2453,5,67,ABU HAIL,أبو هيل
2018,2453,0,67,ABU HAIL,أبو هيل
2019,2453,9,76,ABU HAIL,أبو هيل
2020,2453,36,112,ABU HAIL,أبو هيل
2021,2453,0,112,ABU HAIL,أبو هيل
1963,2493,0,0,MUHAISANAH FOURTH,محيصنة الرابعة
1964,2493,0,0,MUHAISANAH FOURTH,محيصنة الرابعة
1965,2493,0,0,MUHAISANAH FOURTH,محيصنة الرابعة
1966,2493,0,0,MUHAISANAH FOURTH,محيصنة الرابعة
1967,2493,0,0,MUHAISANAH FOURTH,محيصنة الرابعة
1968,2493,0,0,MUHAISANAH FOURTH,محيصنة الرابعة
1969,2493,0,0,MUHAISANAH FOURTH,محيصنة الرابعة
1970,2493,0,0,MUHAISANAH FOURTH,محيصنة الرابعة
1971,2493,0,0,MUHAISANAH FOURTH,محيصنة الرابعة
1972,2493,0,0,MUHAISANAH FOURTH,محيصنة الرابعة
1973,2493,0,0,MUHAISANAH FOURTH,محيصنة الرابعة
1974,2493,0,0,MUHAISANAH FOURTH,محيصنة الرابعة
1975,2493,0,0,MUHAISANAH FOURTH,محيصنة الرابعة
1976,2493,1,1,MUHAISANAH FOURTH,محيصنة الرابعة
1977,2493,0,1,MUHAISANAH FOURTH,محيصنة الرابعة
1978,2493,0,1,MUHAISANAH FOURTH,محيصنة الرابعة
1979,2493,0,1,MUHAISANAH FOURTH,محيصنة الرابعة
1980,2493,0,1,MUHAISANAH FOURTH,محيصنة الرابعة
1981,2493,0,1,MUHAISANAH FOURTH,محيصنة الرابعة
1982,2493,0,1,MUHAISANAH FOURTH,محيصنة الرابعة
1983,2493,0,1,MUHAISANAH FOURTH,محيصنة الرابعة
1984,2493,0,1,MUHAISANAH FOURTH,محيصنة الرابعة
1985,2493,0,1,MUHAISANAH FOURTH,محيصنة الرابعة
1986,2493,1,2,MUHAISANAH FOURTH,محيصنة الرابعة
1987,2493,0,2,MUHAISANAH FOURTH,محيصنة الرابعة
1988,2493,1,3,MUHAISANAH FOURTH,محيصنة الرابعة
1989,2493,0,3,MUHAISANAH FOURTH,محيصنة الرابعة
1990,2493,1,4,MUHAISANAH FOURTH,محيصنة الرابعة
1991,2493,0,4,MUHAISANAH FOURTH,محيصنة الرابعة
1992,2493,2,6,MUHAISANAH FOURTH,محيصنة الرابعة
1993,2493,0,6,MUHAISANAH FOURTH,محيصنة الرابعة
1994,2493,3,9,MUHAISANAH FOURTH,محيصنة الرابعة
1995,2493,1,10,MUHAISANAH FOURTH,محيصنة الرابعة
1996,2493,0,10,MUHAISANAH FOURTH,محيصنة الرابعة
1997,2493,1,11,MUHAISANAH FOURTH,محيصنة الرابعة
1998,2493,1,12,MUHAISANAH FOURTH,محيصنة الرابعة
1999,2493,1,13,MUHAISANAH FOURTH,محيصنة الرابعة
2000,2493,0,13,MUHAISANAH FOURTH,محيصنة الرابعة
2001,2493,1,14,MUHAISANAH FOURTH,محيصنة الرابعة
2002,2493,1,15,MUHAISANAH FOURTH,محيصنة الرابعة
2003,2493,0,15,MUHAISANAH FOURTH,محيصنة الرابعة
2004,2493,6,21,MUHAISANAH FOURTH,محيصنة الرابعة
2005,2493,1,22,MUHAISANAH FOURTH,محيصنة الرابعة
2006,2493,1,23,MUHAISANAH FOURTH,محيصنة الرابعة
2007,2493,1,24,MUHAISANAH FOURTH,محيصنة الرابعة
2008,2493,3,27,MUHAISANAH FOURTH,محيصنة الرابعة
2009,2493,0,27,MUHAISANAH FOURTH,محيصنة الرابعة
2010,2493,5,32,MUHAISANAH FOURTH,محيصنة الرابعة
2011,2493,3,35,MUHAISANAH FOURTH,محيصنة الرابعة
2012,2493,11,46,MUHAISANAH FOURTH,محيصنة الرابعة
2013,2493,9,55,MUHAISANAH FOURTH,محيصنة الرابعة
2014,2493,16,71,MUHAISANAH FOURTH,محيصنة الرابعة
2015,2493,9,80,MUHAISANAH FOURTH,محيصنة الرابعة
2016,2493,3,83,MUHAISANAH FOURTH,محيصنة الرابعة
2017,2493,12,95,MUHAISANAH FOURTH,محيصنة الرابعة
2018,2493,11,106,MUHAISANAH FOURTH,محيصنة الرابعة
2019,2493,10,116,MUHAISANAH FOURTH,محيصنة الرابعة
2020,2493,36,152,MUHAISANAH FOURTH,محيصنة الرابعة
2021,2493,0,152,MUHAISANAH FOURTH,محيصنة الرابعة
1963,2533,2,2,AL RAFFA,الرفاعة
1964,2533,0,2,AL RAFFA,الرفاعة
1965,2533,0,2,AL RAFFA,الرفاعة
1966,2533,0,2,AL RAFFA,الرفاعة
1967,2533,0,2,AL RAFFA,الرفاعة
1968,2533,0,2,AL RAFFA,الرفاعة
1969,2533,1,3,AL RAFFA,الرفاعة
1970,2533,1,4,AL RAFFA,الرفاعة
1971,2533,1,5,AL RAFFA,الرفاعة
1972,2533,1,6,AL RAFFA,الرفاعة
1973,2533,4,10,AL RAFFA,الرفاعة
1974,2533,1,11,AL RAFFA,الرفاعة
1975,2533,4,15,AL RAFFA,الرفاعة
1976,2533,5,20,AL RAFFA,الرفاعة
1977,2533,4,24,AL RAFFA,الرفاعة
1978,2533,2,26,AL RAFFA,الرفاعة
1979,2533,2,28,AL RAFFA,الرفاعة
1980,2533,2,30,AL RAFFA,الرفاعة
1981,2533,6,36,AL RAFFA,الرفاعة
1982,2533,8,44,AL RAFFA,الرفاعة
1983,2533,3,47,AL RAFFA,الرفاعة
1984,2533,3,50,AL RAFFA,الرفاعة
1985,2533,6,56,AL RAFFA,الرفاعة
1986,2533,6,62,AL RAFFA,الرفاعة
1987,2533,4,66,AL RAFFA,الرفاعة
1988,2533,6,72,AL RAFFA,الرفاعة
1989,2533,11,83,AL RAFFA,الرفاعة
1990,2533,10,93,AL RAFFA,الرفاعة
1991,2533,7,100,AL RAFFA,الرفاعة
1992,2533,11,111,AL RAFFA,الرفاعة
1993,2533,10,121,AL RAFFA,الرفاعة
1994,2533,5,126,AL RAFFA,الرفاعة
1995,2533,7,133,AL RAFFA,الرفاعة
1996,2533,9,142,AL RAFFA,الرفاعة
1997,2533,17,159,AL RAFFA,الرفاعة
1998,2533,11,170,AL RAFFA,الرفاعة
1999,2533,9,179,AL RAFFA,الرفاعة
2000,2533,10,189,AL RAFFA,الرفاعة
2001,2533,17,206,AL RAFFA,الرفاعة
2002,2533,16,222,AL RAFFA,الرفاعة
2003,2533,22,244,AL RAFFA,الرفاعة
2004,2533,25,269,AL RAFFA,الرفاعة
2005,2533,22,291,AL RAFFA,الرفاعة
2006,2533,37,328,AL RAFFA,الرفاعة
2007,2533,24,352,AL RAFFA,الرفاعة
2008,2533,25,377,AL RAFFA,الرفاعة
2009,2533,17,394,AL RAFFA,الرفاعة
2010,2533,24,418,AL RAFFA,الرفاعة
2011,2533,23,441,AL RAFFA,الرفاعة
2012,2533,31,472,AL RAFFA,الرفاعة
2013,2533,27,499,AL RAFFA,الرفاعة
2014,2533,43,542,AL RAFFA,الرفاعة
2015,2533,30,572,AL RAFFA,الرفاعة
2016,2533,49,621,AL RAFFA,الرفاعة
2017,2533,38,659,AL RAFFA,الرفاعة
2018,2533,41,700,AL RAFFA,الرفاعة
2019,2533,59,759,AL RAFFA,الرفاعة
2020,2533,134,893,AL RAFFA,الرفاعة
2021,2533,0,893,AL RAFFA,الرفاعة
1963,2573,0,0,AL JADAF,الجداف
1964,2573,0,0,AL JADAF,الجداف
1965,2573,0,0,AL JADAF,الجداف
1966,2573,0,0,AL JADAF,الجداف
1967,2573,0,0,AL JADAF,الجداف
1968,2573,0,0,AL JADAF,الجداف
1969,2573,0,0,AL JADAF,الجداف
1970,2573,0,0,AL JADAF,الجداف
1971,2573,0,0,AL JADAF,الجداف
1972,2573,0,0,AL JADAF,الجداف
1973,2573,0,0,AL JADAF,الجداف
1974,2573,0,0,AL JADAF,الجداف
1975,2573,0,0,AL JADAF,الجداف
1976,2573,0,0,AL JADAF,الجداف
1977,2573,2,2,AL JADAF,الجداف
1978,2573,3,5,AL JADAF,الجداف
1979,2573,0,5,AL JADAF,الجداف
1980,2573,3,8,AL JADAF,الجداف
1981,2573,2,10,AL JADAF,الجداف
1982,2573,3,13,AL JADAF,الجداف
1983,2573,1,14,AL JADAF,الجداف
1984,2573,2,16,AL JADAF,الجداف
1985,2573,1,17,AL JADAF,الجداف
1986,2573,0,17,AL JADAF,الجداف
1987,2573,2,19,AL JADAF,الجداف
1988,2573,1,20,AL JADAF,الجداف
1989,2573,4,24,AL JADAF,الجداف
1990,2573,4,28,AL JADAF,الجداف
1991,2573,3,31,AL JADAF,الجداف
1992,2573,3,34,AL JADAF,الجداف
1993,2573,1,35,AL JADAF,الجداف
1994,2573,2,37,AL JADAF,الجداف
1995,2573,6,43,AL JADAF,الجداف
1996,2573,5,48,AL JADAF,الجداف
1997,2573,1,49,AL JADAF,الجداف
1998,2573,6,55,AL JADAF,الجداف
1999,2573,4,59,AL JADAF,الجداف
2000,2573,5,64,AL JADAF,الجداف
2001,2573,4,68,AL JADAF,الجداف
2002,2573,4,72,AL JADAF,الجداف
2003,2573,2,74,AL JADAF,الجداف
2004,2573,8,82,AL JADAF,الجداف
2005,2573,3,85,AL JADAF,الجداف
2006,2573,7,92,AL JADAF,الجداف
2007,2573,7,99,AL JADAF,الجداف
2008,2573,6,105,AL JADAF,الجداف
2009,2573,6,111,AL JADAF,الجداف
2010,2573,13,124,AL JADAF,الجداف
2011,2573,12,136,AL JADAF,الجداف
2012,2573,11,147,AL JADAF,الجداف
2013,2573,11,158,AL JADAF,الجداف
2014,2573,16,174,AL JADAF,الجداف
2015,2573,15,189,AL JADAF,الجداف
2016,2573,7,196,AL JADAF,الجداف
2017,2573,24,220,AL JADAF,الجداف
2018,2573,20,240,AL JADAF,الجداف
2019,2573,24,264,AL JADAF,الجداف
2020,2573,59,323,AL JADAF,الجداف
2021,2573,0,323,AL JADAF,الجداف
1963,2613,1,1,AL QOUZ IND.THIRD,القوز الصناعية الثالثة
1964,2613,0,1,AL QOUZ IND.THIRD,القوز الصناعية الثالثة
1965,2613,0,1,AL QOUZ IND.THIRD,القوز الصناعية الثالثة
1966,2613,0,1,AL QOUZ IND.THIRD,القوز الصناعية الثالثة
1967,2613,0,1,AL QOUZ IND.THIRD,القوز الصناعية الثالثة
1968,2613,0,1,AL QOUZ IND.THIRD,القوز الصناعية الثالثة
1969,2613,0,1,AL QOUZ IND.THIRD,القوز الصناعية الثالثة
1970,2613,1,2,AL QOUZ IND.THIRD,القوز الصناعية الثالثة
1971,2613,0,2,AL QOUZ IND.THIRD,القوز الصناعية الثالثة
1972,2613,0,2,AL QOUZ IND.THIRD,القوز الصناعية الثالثة
1973,2613,0,2,AL QOUZ IND.THIRD,القوز الصناعية الثالثة
1974,2613,0,2,AL QOUZ IND.THIRD,القوز الصناعية الثالثة
1975,2613,2,4,AL QOUZ IND.THIRD,القوز الصناعية الثالثة
1976,2613,2,6,AL QOUZ IND.THIRD,القوز الصناعية الثالثة
1977,2613,5,11,AL QOUZ IND.THIRD,القوز الصناعية الثالثة
1978,2613,1,12,AL QOUZ IND.THIRD,القوز الصناعية الثالثة
1979,2613,3,15,AL QOUZ IND.THIRD,القوز الصناعية الثالثة
1980,2613,2,17,AL QOUZ IND.THIRD,القوز الصناعية الثالثة
1981,2613,3,20,AL QOUZ IND.THIRD,القوز الصناعية الثالثة
1982,2613,5,25,AL QOUZ IND.THIRD,القوز الصناعية الثالثة
1983,2613,2,27,AL QOUZ IND.THIRD,القوز الصناعية الثالثة
1984,2613,4,31,AL QOUZ IND.THIRD,القوز الصناعية الثالثة
1985,2613,1,32,AL QOUZ IND.THIRD,القوز الصناعية الثالثة
1986,2613,5,37,AL QOUZ IND.THIRD,القوز الصناعية الثالثة
1987,2613,1,38,AL QOUZ IND.THIRD,القوز الصناعية الثالثة
1988,2613,3,41,AL QOUZ IND.THIRD,القوز الصناعية الثالثة
1989,2613,3,44,AL QOUZ IND.THIRD,القوز الصناعية الثالثة
1990,2613,3,47,AL QOUZ IND.THIRD,القوز الصناعية الثالثة
1991,2613,0,47,AL QOUZ IND.THIRD,القوز الصناعية الثالثة
1992,2613,6,53,AL QOUZ IND.THIRD,القوز الصناعية الثالثة
1993,2613,6,59,AL QOUZ IND.THIRD,القوز الصناعية الثالثة
1994,2613,4,63,AL QOUZ IND.THIRD,القوز الصناعية الثالثة
1995,2613,5,68,AL QOUZ IND.THIRD,القوز الصناعية الثالثة
1996,2613,9,77,AL QOUZ IND.THIRD,القوز الصناعية الثالثة
1997,2613,9,86,AL QOUZ IND.THIRD,القوز الصناعية الثالثة
1998,2613,9,95,AL QOUZ IND.THIRD,القوز الصناعية الثالثة
1999,2613,7,102,AL QOUZ IND.THIRD,القوز الصناعية الثالثة
2000,2613,10,112,AL QOUZ IND.THIRD,القوز الصناعية الثالثة
2001,2613,7,119,AL QOUZ IND.THIRD,القوز الصناعية الثالثة
2002,2613,14,133,AL QOUZ IND.THIRD,القوز الصناعية الثالثة
2003,2613,12,145,AL QOUZ IND.THIRD,القوز الصناعية الثالثة
2004,2613,18,163,AL QOUZ IND.THIRD,القوز الصناعية الثالثة
2005,2613,17,180,AL QOUZ IND.THIRD,القوز الصناعية الثالثة
2006,2613,16,196,AL QOUZ IND.THIRD,القوز الصناعية الثالثة
2007,2613,19,215,AL QOUZ IND.THIRD,القوز الصناعية الثالثة
2008,2613,13,228,AL QOUZ IND.THIRD,القوز الصناعية الثالثة
2009,2613,18,246,AL QOUZ IND.THIRD,القوز الصناعية الثالثة
2010,2613,23,269,AL QOUZ IND.THIRD,القوز الصناعية الثالثة
2011,2613,24,293,AL QOUZ IND.THIRD,القوز الصناعية الثالثة
2012,2613,29,322,AL QOUZ IND.THIRD,القوز الصناعية الثالثة
2013,2613,33,355,AL QOUZ IND.THIRD,القوز الصناعية الثالثة
2014,2613,54,409,AL QOUZ IND.THIRD,القوز الصناعية الثالثة
2015,2613,44,453,AL QOUZ IND.THIRD,القوز الصناعية الثالثة
2016,2613,59,512,AL QOUZ IND.THIRD,القوز الصناعية الثالثة
2017,2613,70,582,AL QOUZ IND.THIRD,القوز الصناعية الثالثة
2018,2613,70,652,AL QOUZ IND.THIRD,القوز الصناعية الثالثة
2019,2613,81,733,AL QOUZ IND.THIRD,القوز الصناعية الثالثة
2020,2613,162,895,AL QOUZ IND.THIRD,القوز الصناعية الثالثة
2021,2613,0,895,AL QOUZ IND.THIRD,القوز الصناعية الثالثة
1963,2653,0,0,TRADE CENTER FIRST,المركز التجاري الأولى
1964,2653,0,0,TRADE CENTER FIRST,المركز التجاري الأولى
1965,2653,2,2,TRADE CENTER FIRST,المركز التجاري الأولى
1966,2653,2,4,TRADE CENTER FIRST,المركز التجاري الأولى
1967,2653,1,5,TRADE CENTER FIRST,المركز التجاري الأولى
1968,2653,0,5,TRADE CENTER FIRST,المركز التجاري الأولى
1969,2653,1,6,TRADE CENTER FIRST,المركز التجاري الأولى
1970,2653,1,7,TRADE CENTER FIRST,المركز التجاري الأولى
1971,2653,1,8,TRADE CENTER FIRST,المركز التجاري الأولى
1972,2653,1,9,TRADE CENTER FIRST,المركز التجاري الأولى
1973,2653,2,11,TRADE CENTER FIRST,المركز التجاري الأولى
1974,2653,2,13,TRADE CENTER FIRST,المركز التجاري الأولى
1975,2653,5,18,TRADE CENTER FIRST,المركز التجاري الأولى
1976,2653,1,19,TRADE CENTER FIRST,المركز التجاري الأولى
1977,2653,5,24,TRADE CENTER FIRST,المركز التجاري الأولى
1978,2653,2,26,TRADE CENTER FIRST,المركز التجاري الأولى
1979,2653,3,29,TRADE CENTER FIRST,المركز التجاري الأولى
1980,2653,4,33,TRADE CENTER FIRST,المركز التجاري الأولى
1981,2653,10,43,TRADE CENTER FIRST,المركز التجاري الأولى
1982,2653,5,48,TRADE CENTER FIRST,المركز التجاري الأولى
1983,2653,5,53,TRADE CENTER FIRST,المركز التجاري الأولى
1984,2653,4,57,TRADE CENTER FIRST,المركز التجاري الأولى
1985,2653,3,60,TRADE CENTER FIRST,المركز التجاري الأولى
1986,2653,3,63,TRADE CENTER FIRST,المركز التجاري الأولى
1987,2653,4,67,TRADE CENTER FIRST,المركز التجاري الأولى
1988,2653,12,79,TRADE CENTER FIRST,المركز التجاري الأولى
1989,2653,4,83,TRADE CENTER FIRST,المركز التجاري الأولى
1990,2653,8,91,TRADE CENTER FIRST,المركز التجاري الأولى
1991,2653,4,95,TRADE CENTER FIRST,المركز التجاري الأولى
1992,2653,8,103,TRADE CENTER FIRST,المركز التجاري الأولى
1993,2653,13,116,TRADE CENTER FIRST,المركز التجاري الأولى
1994,2653,20,136,TRADE CENTER FIRST,المركز التجاري الأولى
1995,2653,12,148,TRADE CENTER FIRST,المركز التجاري الأولى
1996,2653,12,160,TRADE CENTER FIRST,المركز التجاري الأولى
1997,2653,22,182,TRADE CENTER FIRST,المركز التجاري الأولى
1998,2653,37,219,TRADE CENTER FIRST,المركز التجاري الأولى
1999,2653,20,239,TRADE CENTER FIRST,المركز التجاري الأولى
2000,2653,35,274,TRADE CENTER FIRST,المركز التجاري الأولى
2001,2653,34,308,TRADE CENTER FIRST,المركز التجاري الأولى
2002,2653,54,362,TRADE CENTER FIRST,المركز التجاري الأولى
2003,2653,52,414,TRADE CENTER FIRST,المركز التجاري الأولى
2004,2653,70,484,TRADE CENTER FIRST,المركز التجاري الأولى
2005,2653,100,584,TRADE CENTER FIRST,المركز التجاري الأولى
2006,2653,96,680,TRADE CENTER FIRST,المركز التجاري الأولى
2007,2653,112,792,TRADE CENTER FIRST,المركز التجاري الأولى
2008,2653,115,907,TRADE CENTER FIRST,المركز التجاري الأولى
2009,2653,76,983,TRADE CENTER FIRST,المركز التجاري الأولى
2010,2653,87,1070,TRADE CENTER FIRST,المركز التجاري الأولى
2011,2653,90,1160,TRADE CENTER FIRST,المركز التجاري الأولى
2012,2653,132,1292,TRADE CENTER FIRST,المركز التجاري الأولى
2013,2653,167,1459,TRADE CENTER FIRST,المركز التجاري الأولى
2014,2653,199,1658,TRADE CENTER FIRST,المركز التجاري الأولى
2015,2653,209,1867,TRADE CENTER FIRST,المركز التجاري الأولى
2016,2653,212,2079,TRADE CENTER FIRST,المركز التجاري الأولى
2017,2653,218,2297,TRADE CENTER FIRST,المركز التجاري الأولى
2018,2653,284,2581,TRADE CENTER FIRST,المركز التجاري الأولى
2019,2653,519,3100,TRADE CENTER FIRST,المركز التجاري الأولى
2020,2653,910,4010,TRADE CENTER FIRST,المركز التجاري الأولى
2021,2653,0,4010,TRADE CENTER FIRST,المركز التجاري الأولى
1963,2693,0,0,MUHAISANAH SECOND,محيصنة الثانية
1964,2693,0,0,MUHAISANAH SECOND,محيصنة الثانية
1965,2693,0,0,MUHAISANAH SECOND,محيصنة الثانية
1966,2693,0,0,MUHAISANAH SECOND,محيصنة الثانية
1967,2693,0,0,MUHAISANAH SECOND,محيصنة الثانية
1968,2693,0,0,MUHAISANAH SECOND,محيصنة الثانية
1969,2693,0,0,MUHAISANAH SECOND,محيصنة الثانية
1970,2693,1,1,MUHAISANAH SECOND,محيصنة الثانية
1971,2693,0,1,MUHAISANAH SECOND,محيصنة الثانية
1972,2693,0,1,MUHAISANAH SECOND,محيصنة الثانية
1973,2693,0,1,MUHAISANAH SECOND,محيصنة الثانية
1974,2693,0,1,MUHAISANAH SECOND,محيصنة الثانية
1975,2693,0,1,MUHAISANAH SECOND,محيصنة الثانية
1976,2693,0,1,MUHAISANAH SECOND,محيصنة الثانية
1977,2693,1,2,MUHAISANAH SECOND,محيصنة الثانية
1978,2693,0,2,MUHAISANAH SECOND,محيصنة الثانية
1979,2693,0,2,MUHAISANAH SECOND,محيصنة الثانية
1980,2693,0,2,MUHAISANAH SECOND,محيصنة الثانية
1981,2693,1,3,MUHAISANAH SECOND,محيصنة الثانية
1982,2693,3,6,MUHAISANAH SECOND,محيصنة الثانية
1983,2693,4,10,MUHAISANAH SECOND,محيصنة الثانية
1984,2693,1,11,MUHAISANAH SECOND,محيصنة الثانية
1985,2693,0,11,MUHAISANAH SECOND,محيصنة الثانية
1986,2693,2,13,MUHAISANAH SECOND,محيصنة الثانية
1987,2693,1,14,MUHAISANAH SECOND,محيصنة الثانية
1988,2693,0,14,MUHAISANAH SECOND,محيصنة الثانية
1989,2693,1,15,MUHAISANAH SECOND,محيصنة الثانية
1990,2693,0,15,MUHAISANAH SECOND,محيصنة الثانية
1991,2693,1,16,MUHAISANAH SECOND,محيصنة الثانية
1992,2693,2,18,MUHAISANAH SECOND,محيصنة الثانية
1993,2693,2,20,MUHAISANAH SECOND,محيصنة الثانية
1994,2693,0,20,MUHAISANAH SECOND,محيصنة الثانية
1995,2693,0,20,MUHAISANAH SECOND,محيصنة الثانية
1996,2693,0,20,MUHAISANAH SECOND,محيصنة الثانية
1997,2693,1,21,MUHAISANAH SECOND,محيصنة الثانية
1998,2693,0,21,MUHAISANAH SECOND,محيصنة الثانية
1999,2693,1,22,MUHAISANAH SECOND,محيصنة الثانية
2000,2693,0,22,MUHAISANAH SECOND,محيصنة الثانية
2001,2693,0,22,MUHAISANAH SECOND,محيصنة الثانية
2002,2693,1,23,MUHAISANAH SECOND,محيصنة الثانية
2003,2693,2,25,MUHAISANAH SECOND,محيصنة الثانية
2004,2693,6,31,MUHAISANAH SECOND,محيصنة الثانية
2005,2693,2,33,MUHAISANAH SECOND,محيصنة الثانية
2006,2693,5,38,MUHAISANAH SECOND,محيصنة الثانية
2007,2693,0,38,MUHAISANAH SECOND,محيصنة الثانية
2008,2693,3,41,MUHAISANAH SECOND,محيصنة الثانية
2009,2693,2,43,MUHAISANAH SECOND,محيصنة الثانية
2010,2693,6,49,MUHAISANAH SECOND,محيصنة الثانية
2011,2693,8,57,MUHAISANAH SECOND,محيصنة الثانية
2012,2693,6,63,MUHAISANAH SECOND,محيصنة الثانية
2013,2693,9,72,MUHAISANAH SECOND,محيصنة الثانية
2014,2693,19,91,MUHAISANAH SECOND,محيصنة الثانية
2015,2693,18,109,MUHAISANAH SECOND,محيصنة الثانية
2016,2693,8,117,MUHAISANAH SECOND,محيصنة الثانية
2017,2693,25,142,MUHAISANAH SECOND,محيصنة الثانية
2018,2693,10,152,MUHAISANAH SECOND,محيصنة الثانية
2019,2693,18,170,MUHAISANAH SECOND,محيصنة الثانية
2020,2693,20,190,MUHAISANAH SECOND,محيصنة الثانية
2021,2693,0,190,MUHAISANAH SECOND,محيصنة الثانية
1963,2773,1,1,AL MAMZAR,الممزر
1964,2773,0,1,AL MAMZAR,الممزر
1965,2773,0,1,AL MAMZAR,الممزر
1966,2773,0,1,AL MAMZAR,الممزر
1967,2773,0,1,AL MAMZAR,الممزر
1968,2773,0,1,AL MAMZAR,الممزر
1969,2773,0,1,AL MAMZAR,الممزر
1970,2773,0,1,AL MAMZAR,الممزر
1971,2773,0,1,AL MAMZAR,الممزر
1972,2773,2,3,AL MAMZAR,الممزر
1973,2773,1,4,AL MAMZAR,الممزر
1974,2773,0,4,AL MAMZAR,الممزر
1975,2773,0,4,AL MAMZAR,الممزر
1976,2773,1,5,AL MAMZAR,الممزر
1977,2773,0,5,AL MAMZAR,الممزر
1978,2773,0,5,AL MAMZAR,الممزر
1979,2773,0,5,AL MAMZAR,الممزر
1980,2773,1,6,AL MAMZAR,الممزر
1981,2773,0,6,AL MAMZAR,الممزر
1982,2773,0,6,AL MAMZAR,الممزر
1983,2773,1,7,AL MAMZAR,الممزر
1984,2773,0,7,AL MAMZAR,الممزر
1985,2773,2,9,AL MAMZAR,الممزر
1986,2773,1,10,AL MAMZAR,الممزر
1987,2773,0,10,AL MAMZAR,الممزر
1988,2773,0,10,AL MAMZAR,الممزر
1989,2773,1,11,AL MAMZAR,الممزر
1990,2773,2,13,AL MAMZAR,الممزر
1991,2773,4,17,AL MAMZAR,الممزر
1992,2773,3,20,AL MAMZAR,الممزر
1993,2773,2,22,AL MAMZAR,الممزر
1994,2773,0,22,AL MAMZAR,الممزر
1995,2773,1,23,AL MAMZAR,الممزر
1996,2773,0,23,AL MAMZAR,الممزر
1997,2773,1,24,AL MAMZAR,الممزر
1998,2773,5,29,AL MAMZAR,الممزر
1999,2773,2,31,AL MAMZAR,الممزر
2000,2773,9,40,AL MAMZAR,الممزر
2001,2773,5,45,AL MAMZAR,الممزر
2002,2773,5,50,AL MAMZAR,الممزر
2003,2773,19,69,AL MAMZAR,الممزر
2004,2773,9,78,AL MAMZAR,الممزر
2005,2773,13,91,AL MAMZAR,الممزر
2006,2773,11,102,AL MAMZAR,الممزر
2007,2773,25,127,AL MAMZAR,الممزر
2008,2773,26,153,AL MAMZAR,الممزر
2009,2773,11,164,AL MAMZAR,الممزر
2010,2773,10,174,AL MAMZAR,الممزر
2011,2773,26,200,AL MAMZAR,الممزر
2012,2773,28,228,AL MAMZAR,الممزر
2013,2773,23,251,AL MAMZAR,الممزر
2014,2773,31,282,AL MAMZAR,الممزر
2015,2773,49,331,AL MAMZAR,الممزر
2016,2773,44,375,AL MAMZAR,الممزر
2017,2773,34,409,AL MAMZAR,الممزر
2018,2773,52,461,AL MAMZAR,الممزر
2019,2773,73,534,AL MAMZAR,الممزر
2020,2773,119,653,AL MAMZAR,الممزر
2021,2773,0,653,AL MAMZAR,الممزر
1963,2813,0,0,"ME'AISEM FIRST",معيصم الأولى
1964,2813,0,0,"ME'AISEM FIRST",معيصم الأولى
1965,2813,0,0,"ME'AISEM FIRST",معيصم الأولى
1966,2813,0,0,"ME'AISEM FIRST",معيصم الأولى
1967,2813,0,0,"ME'AISEM FIRST",معيصم الأولى
1968,2813,0,0,"ME'AISEM FIRST",معيصم الأولى
1969,2813,0,0,"ME'AISEM FIRST",معيصم الأولى
1970,2813,0,0,"ME'AISEM FIRST",معيصم الأولى
1971,2813,0,0,"ME'AISEM FIRST",معيصم الأولى
1972,2813,0,0,"ME'AISEM FIRST",معيصم الأولى
1973,2813,0,0,"ME'AISEM FIRST",معيصم الأولى
1974,2813,0,0,"ME'AISEM FIRST",معيصم الأولى
1975,2813,0,0,"ME'AISEM FIRST",معيصم الأولى
1976,2813,0,0,"ME'AISEM FIRST",معيصم الأولى
1977,2813,0,0,"ME'AISEM FIRST",معيصم الأولى
1978,2813,0,0,"ME'AISEM FIRST",معيصم الأولى
1979,2813,0,0,"ME'AISEM FIRST",معيصم الأولى
1980,2813,0,0,"ME'AISEM FIRST",معيصم الأولى
1981,2813,0,0,"ME'AISEM FIRST",معيصم الأولى
1982,2813,0,0,"ME'AISEM FIRST",معيصم الأولى
1983,2813,0,0,"ME'AISEM FIRST",معيصم الأولى
1984,2813,0,0,"ME'AISEM FIRST",معيصم الأولى
1985,2813,0,0,"ME'AISEM FIRST",معيصم الأولى
1986,2813,0,0,"ME'AISEM FIRST",معيصم الأولى
1987,2813,0,0,"ME'AISEM FIRST",معيصم الأولى
1988,2813,0,0,"ME'AISEM FIRST",معيصم الأولى
1989,2813,0,0,"ME'AISEM FIRST",معيصم الأولى
1990,2813,0,0,"ME'AISEM FIRST",معيصم الأولى
1991,2813,0,0,"ME'AISEM FIRST",معيصم الأولى
1992,2813,0,0,"ME'AISEM FIRST",معيصم الأولى
1993,2813,0,0,"ME'AISEM FIRST",معيصم الأولى
1994,2813,0,0,"ME'AISEM FIRST",معيصم الأولى
1995,2813,0,0,"ME'AISEM FIRST",معيصم الأولى
1996,2813,1,1,"ME'AISEM FIRST",معيصم الأولى
1997,2813,0,1,"ME'AISEM FIRST",معيصم الأولى
1998,2813,0,1,"ME'AISEM FIRST",معيصم الأولى
1999,2813,0,1,"ME'AISEM FIRST",معيصم الأولى
2000,2813,0,1,"ME'AISEM FIRST",معيصم الأولى
2001,2813,0,1,"ME'AISEM FIRST",معيصم الأولى
2002,2813,1,2,"ME'AISEM FIRST",معيصم الأولى
2003,2813,0,2,"ME'AISEM FIRST",معيصم الأولى
2004,2813,0,2,"ME'AISEM FIRST",معيصم الأولى
2005,2813,0,2,"ME'AISEM FIRST",معيصم الأولى
2006,2813,0,2,"ME'AISEM FIRST",معيصم الأولى
2007,2813,2,4,"ME'AISEM FIRST",معيصم الأولى
2008,2813,0,4,"ME'AISEM FIRST",معيصم الأولى
2009,2813,0,4,"ME'AISEM FIRST",معيصم الأولى
2010,2813,1,5,"ME'AISEM FIRST",معيصم الأولى
2011,2813,1,6,"ME'AISEM FIRST",معيصم الأولى
2012,2813,1,7,"ME'AISEM FIRST",معيصم الأولى
2013,2813,1,8,"ME'AISEM FIRST",معيصم الأولى
2014,2813,0,8,"ME'AISEM FIRST",معيصم الأولى
2015,2813,1,9,"ME'AISEM FIRST",معيصم الأولى
2016,2813,1,10,"ME'AISEM FIRST",معيصم الأولى
2017,2813,5,15,"ME'AISEM FIRST",معيصم الأولى
2018,2813,8,23,"ME'AISEM FIRST",معيصم الأولى
2019,2813,11,34,"ME'AISEM FIRST",معيصم الأولى
2020,2813,24,58,"ME'AISEM FIRST",معيصم الأولى
2021,2813,0,58,"ME'AISEM FIRST",معيصم الأولى
1963,3013,0,0,AL SHINDAGHA,الشندغة
1964,3013,0,0,AL SHINDAGHA,الشندغة
1965,3013,0,0,AL SHINDAGHA,الشندغة
1966,3013,0,0,AL SHINDAGHA,الشندغة
1967,3013,0,0,AL SHINDAGHA,الشندغة
1968,3013,0,0,AL SHINDAGHA,الشندغة
1969,3013,0,0,AL SHINDAGHA,الشندغة
1970,3013,0,0,AL SHINDAGHA,الشندغة
1971,3013,0,0,AL SHINDAGHA,الشندغة
1972,3013,0,0,AL SHINDAGHA,الشندغة
1973,3013,0,0,AL SHINDAGHA,الشندغة
1974,3013,0,0,AL SHINDAGHA,الشندغة
1975,3013,0,0,AL SHINDAGHA,الشندغة
1976,3013,0,0,AL SHINDAGHA,الشندغة
1977,3013,1,1,AL SHINDAGHA,الشندغة
1978,3013,0,1,AL SHINDAGHA,الشندغة
1979,3013,0,1,AL SHINDAGHA,الشندغة
1980,3013,1,2,AL SHINDAGHA,الشندغة
1981,3013,0,2,AL SHINDAGHA,الشندغة
1982,3013,1,3,AL SHINDAGHA,الشندغة
1983,3013,1,4,AL SHINDAGHA,الشندغة
1984,3013,0,4,AL SHINDAGHA,الشندغة
1985,3013,0,4,AL SHINDAGHA,الشندغة
1986,3013,0,4,AL SHINDAGHA,الشندغة
1987,3013,1,5,AL SHINDAGHA,الشندغة
1988,3013,0,5,AL SHINDAGHA,الشندغة
1989,3013,0,5,AL SHINDAGHA,الشندغة
1990,3013,1,6,AL SHINDAGHA,الشندغة
1991,3013,1,7,AL SHINDAGHA,الشندغة
1992,3013,1,8,AL SHINDAGHA,الشندغة
1993,3013,0,8,AL SHINDAGHA,الشندغة
1994,3013,0,8,AL SHINDAGHA,الشندغة
1995,3013,0,8,AL SHINDAGHA,الشندغة
1996,3013,0,8,AL SHINDAGHA,الشندغة
1997,3013,1,9,AL SHINDAGHA,الشندغة
1998,3013,2,11,AL SHINDAGHA,الشندغة
1999,3013,0,11,AL SHINDAGHA,الشندغة
2000,3013,1,12,AL SHINDAGHA,الشندغة
2001,3013,1,13,AL SHINDAGHA,الشندغة
2002,3013,2,15,AL SHINDAGHA,الشندغة
2003,3013,1,16,AL SHINDAGHA,الشندغة
2004,3013,4,20,AL SHINDAGHA,الشندغة
2005,3013,1,21,AL SHINDAGHA,الشندغة
2006,3013,2,23,AL SHINDAGHA,الشندغة
2007,3013,1,24,AL SHINDAGHA,الشندغة
2008,3013,1,25,AL SHINDAGHA,الشندغة
2009,3013,1,26,AL SHINDAGHA,الشندغة
2010,3013,1,27,AL SHINDAGHA,الشندغة
2011,3013,0,27,AL SHINDAGHA,الشندغة
2012,3013,1,28,AL SHINDAGHA,الشندغة
2013,3013,0,28,AL SHINDAGHA,الشندغة
2014,3013,1,29,AL SHINDAGHA,الشندغة
2015,3013,13,42,AL SHINDAGHA,الشندغة
2016,3013,3,45,AL SHINDAGHA,الشندغة
2017,3013,0,45,AL SHINDAGHA,الشندغة
2018,3013,4,49,AL SHINDAGHA,الشندغة
2019,3013,8,57,AL SHINDAGHA,الشندغة
2020,3013,1,58,AL SHINDAGHA,الشندغة
2021,3013,0,58,AL SHINDAGHA,الشندغة
1963,3053,0,0,RAS AL KHOR,راس الخور
1964,3053,0,0,RAS AL KHOR,راس الخور
1965,3053,0,0,RAS AL KHOR,راس الخور
1966,3053,0,0,RAS AL KHOR,راس الخور
1967,3053,0,0,RAS AL KHOR,راس الخور
1968,3053,0,0,RAS AL KHOR,راس الخور
1969,3053,0,0,RAS AL KHOR,راس الخور
1970,3053,0,0,RAS AL KHOR,راس الخور
1971,3053,0,0,RAS AL KHOR,راس الخور
1972,3053,0,0,RAS AL KHOR,راس الخور
1973,3053,3,3,RAS AL KHOR,راس الخور
1974,3053,3,6,RAS AL KHOR,راس الخور
1975,3053,3,9,RAS AL KHOR,راس الخور
1976,3053,4,13,RAS AL KHOR,راس الخور
1977,3053,2,15,RAS AL KHOR,راس الخور
1978,3053,3,18,RAS AL KHOR,راس الخور
1979,3053,2,20,RAS AL KHOR,راس الخور
1980,3053,9,29,RAS AL KHOR,راس الخور
1981,3053,12,41,RAS AL KHOR,راس الخور
1982,3053,4,45,RAS AL KHOR,راس الخور
1983,3053,6,51,RAS AL KHOR,راس الخور
1984,3053,4,55,RAS AL KHOR,راس الخور
1985,3053,2,57,RAS AL KHOR,راس الخور
1986,3053,5,62,RAS AL KHOR,راس الخور
1987,3053,3,65,RAS AL KHOR,راس الخور
1988,3053,9,74,RAS AL KHOR,راس الخور
1989,3053,12,86,RAS AL KHOR,راس الخور
1990,3053,7,93,RAS AL KHOR,راس الخور
1991,3053,9,102,RAS AL KHOR,راس الخور
1992,3053,7,109,RAS AL KHOR,راس الخور
1993,3053,11,120,RAS AL KHOR,راس الخور
1994,3053,8,128,RAS AL KHOR,راس الخور
1995,3053,12,140,RAS AL KHOR,راس الخور
1996,3053,15,155,RAS AL KHOR,راس الخور
1997,3053,18,173,RAS AL KHOR,راس الخور
1998,3053,18,191,RAS AL KHOR,راس الخور
1999,3053,28,219,RAS AL KHOR,راس الخور
2000,3053,15,234,RAS AL KHOR,راس الخور
2001,3053,21,255,RAS AL KHOR,راس الخور
2002,3053,23,278,RAS AL KHOR,راس الخور
2003,3053,31,309,RAS AL KHOR,راس الخور
2004,3053,55,364,RAS AL KHOR,راس الخور
2005,3053,29,393,RAS AL KHOR,راس الخور
2006,3053,44,437,RAS AL KHOR,راس الخور
2007,3053,48,485,RAS AL KHOR,راس الخور
2008,3053,22,507,RAS AL KHOR,راس الخور
2009,3053,25,532,RAS AL KHOR,راس الخور
2010,3053,31,563,RAS AL KHOR,راس الخور
2011,3053,25,588,RAS AL KHOR,راس الخور
2012,3053,27,615,RAS AL KHOR,راس الخور
2013,3053,33,648,RAS AL KHOR,راس الخور
2014,3053,18,666,RAS AL KHOR,راس الخور
2015,3053,19,685,RAS AL KHOR,راس الخور
2016,3053,27,712,RAS AL KHOR,راس الخور
2017,3053,12,724,RAS AL KHOR,راس الخور
2018,3053,14,738,RAS AL KHOR,راس الخور
2019,3053,22,760,RAS AL KHOR,راس الخور
2020,3053,61,821,RAS AL KHOR,راس الخور
2021,3053,0,821,RAS AL KHOR,راس الخور
1963,3093,0,0,AL TWAR SECOND,الطوار الثانية
1964,3093,0,0,AL TWAR SECOND,الطوار الثانية
1965,3093,0,0,AL TWAR SECOND,الطوار الثانية
1966,3093,0,0,AL TWAR SECOND,الطوار الثانية
1967,3093,0,0,AL TWAR SECOND,الطوار الثانية
1968,3093,0,0,AL TWAR SECOND,الطوار الثانية
1969,3093,0,0,AL TWAR SECOND,الطوار الثانية
1970,3093,0,0,AL TWAR SECOND,الطوار الثانية
1971,3093,0,0,AL TWAR SECOND,الطوار الثانية
1972,3093,0,0,AL TWAR SECOND,الطوار الثانية
1973,3093,0,0,AL TWAR SECOND,الطوار الثانية
1974,3093,0,0,AL TWAR SECOND,الطوار الثانية
1975,3093,0,0,AL TWAR SECOND,الطوار الثانية
1976,3093,0,0,AL TWAR SECOND,الطوار الثانية
1977,3093,0,0,AL TWAR SECOND,الطوار الثانية
1978,3093,0,0,AL TWAR SECOND,الطوار الثانية
1979,3093,0,0,AL TWAR SECOND,الطوار الثانية
1980,3093,0,0,AL TWAR SECOND,الطوار الثانية
1981,3093,0,0,AL TWAR SECOND,الطوار الثانية
1982,3093,0,0,AL TWAR SECOND,الطوار الثانية
1983,3093,0,0,AL TWAR SECOND,الطوار الثانية
1984,3093,0,0,AL TWAR SECOND,الطوار الثانية
1985,3093,0,0,AL TWAR SECOND,الطوار الثانية
1986,3093,0,0,AL TWAR SECOND,الطوار الثانية
1987,3093,0,0,AL TWAR SECOND,الطوار الثانية
1988,3093,0,0,AL TWAR SECOND,الطوار الثانية
1989,3093,0,0,AL TWAR SECOND,الطوار الثانية
1990,3093,0,0,AL TWAR SECOND,الطوار الثانية
1991,3093,0,0,AL TWAR SECOND,الطوار الثانية
1992,3093,1,1,AL TWAR SECOND,الطوار الثانية
1993,3093,0,1,AL TWAR SECOND,الطوار الثانية
1994,3093,1,2,AL TWAR SECOND,الطوار الثانية
1995,3093,0,2,AL TWAR SECOND,الطوار الثانية
1996,3093,0,2,AL TWAR SECOND,الطوار الثانية
1997,3093,0,2,AL TWAR SECOND,الطوار الثانية
1998,3093,0,2,AL TWAR SECOND,الطوار الثانية
1999,3093,1,3,AL TWAR SECOND,الطوار الثانية
2000,3093,1,4,AL TWAR SECOND,الطوار الثانية
2001,3093,0,4,AL TWAR SECOND,الطوار الثانية
2002,3093,0,4,AL TWAR SECOND,الطوار الثانية
2003,3093,0,4,AL TWAR SECOND,الطوار الثانية
2004,3093,0,4,AL TWAR SECOND,الطوار الثانية
2005,3093,1,5,AL TWAR SECOND,الطوار الثانية
2006,3093,1,6,AL TWAR SECOND,الطوار الثانية
2007,3093,1,7,AL TWAR SECOND,الطوار الثانية
2008,3093,0,7,AL TWAR SECOND,الطوار الثانية
2009,3093,1,8,AL TWAR SECOND,الطوار الثانية
2010,3093,1,9,AL TWAR SECOND,الطوار الثانية
2011,3093,0,9,AL TWAR SECOND,الطوار الثانية
2012,3093,0,9,AL TWAR SECOND,الطوار الثانية
2013,3093,0,9,AL TWAR SECOND,الطوار الثانية
2014,3093,3,12,AL TWAR SECOND,الطوار الثانية
2015,3093,1,13,AL TWAR SECOND,الطوار الثانية
2016,3093,2,15,AL TWAR SECOND,الطوار الثانية
2017,3093,3,18,AL TWAR SECOND,الطوار الثانية
2018,3093,5,23,AL TWAR SECOND,الطوار الثانية
2019,3093,7,30,AL TWAR SECOND,الطوار الثانية
2020,3093,26,56,AL TWAR SECOND,الطوار الثانية
2021,3093,0,56,AL TWAR SECOND,الطوار الثانية
1963,3133,0,0,AL HUDAIBA,الحضيبة
1964,3133,0,0,AL HUDAIBA,الحضيبة
1965,3133,0,0,AL HUDAIBA,الحضيبة
1966,3133,0,0,AL HUDAIBA,الحضيبة
1967,3133,0,0,AL HUDAIBA,الحضيبة
1968,3133,0,0,AL HUDAIBA,الحضيبة
1969,3133,0,0,AL HUDAIBA,الحضيبة
1970,3133,0,0,AL HUDAIBA,الحضيبة
1971,3133,0,0,AL HUDAIBA,الحضيبة
1972,3133,1,1,AL HUDAIBA,الحضيبة
1973,3133,0,1,AL HUDAIBA,الحضيبة
1974,3133,0,1,AL HUDAIBA,الحضيبة
1975,3133,0,1,AL HUDAIBA,الحضيبة
1976,3133,1,2,AL HUDAIBA,الحضيبة
1977,3133,0,2,AL HUDAIBA,الحضيبة
1978,3133,0,2,AL HUDAIBA,الحضيبة
1979,3133,0,2,AL HUDAIBA,الحضيبة
1980,3133,0,2,AL HUDAIBA,الحضيبة
1981,3133,1,3,AL HUDAIBA,الحضيبة
1982,3133,0,3,AL HUDAIBA,الحضيبة
1983,3133,1,4,AL HUDAIBA,الحضيبة
1984,3133,1,5,AL HUDAIBA,الحضيبة
1985,3133,0,5,AL HUDAIBA,الحضيبة
1986,3133,0,5,AL HUDAIBA,الحضيبة
1987,3133,0,5,AL HUDAIBA,الحضيبة
1988,3133,2,7,AL HUDAIBA,الحضيبة
1989,3133,1,8,AL HUDAIBA,الحضيبة
1990,3133,3,11,AL HUDAIBA,الحضيبة
1991,3133,0,11,AL HUDAIBA,الحضيبة
1992,3133,1,12,AL HUDAIBA,الحضيبة
1993,3133,1,13,AL HUDAIBA,الحضيبة
1994,3133,0,13,AL HUDAIBA,الحضيبة
1995,3133,3,16,AL HUDAIBA,الحضيبة
1996,3133,1,17,AL HUDAIBA,الحضيبة
1997,3133,1,18,AL HUDAIBA,الحضيبة
1998,3133,3,21,AL HUDAIBA,الحضيبة
1999,3133,2,23,AL HUDAIBA,الحضيبة
2000,3133,3,26,AL HUDAIBA,الحضيبة
2001,3133,8,34,AL HUDAIBA,الحضيبة
2002,3133,2,36,AL HUDAIBA,الحضيبة
2003,3133,4,40,AL HUDAIBA,الحضيبة
2004,3133,2,42,AL HUDAIBA,الحضيبة
2005,3133,0,42,AL HUDAIBA,الحضيبة
2006,3133,3,45,AL HUDAIBA,الحضيبة
2007,3133,4,49,AL HUDAIBA,الحضيبة
2008,3133,5,54,AL HUDAIBA,الحضيبة
2009,3133,3,57,AL HUDAIBA,الحضيبة
2010,3133,9,66,AL HUDAIBA,الحضيبة
2011,3133,11,77,AL HUDAIBA,الحضيبة
2012,3133,8,85,AL HUDAIBA,الحضيبة
2013,3133,1,86,AL HUDAIBA,الحضيبة
2014,3133,10,96,AL HUDAIBA,الحضيبة
2015,3133,9,105,AL HUDAIBA,الحضيبة
2016,3133,8,113,AL HUDAIBA,الحضيبة
2017,3133,9,122,AL HUDAIBA,الحضيبة
2018,3133,6,128,AL HUDAIBA,الحضيبة
2019,3133,8,136,AL HUDAIBA,الحضيبة
2020,3133,34,170,AL HUDAIBA,الحضيبة
2021,3133,0,170,AL HUDAIBA,الحضيبة
1963,3213,6,6,AL RIGGA,الرقة
1964,3213,1,7,AL RIGGA,الرقة
1965,3213,4,11,AL RIGGA,الرقة
1966,3213,0,11,AL RIGGA,الرقة
1967,3213,1,12,AL RIGGA,الرقة
1968,3213,0,12,AL RIGGA,الرقة
1969,3213,2,14,AL RIGGA,الرقة
1970,3213,2,16,AL RIGGA,الرقة
1971,3213,3,19,AL RIGGA,الرقة
1972,3213,4,23,AL RIGGA,الرقة
1973,3213,1,24,AL RIGGA,الرقة
1974,3213,6,30,AL RIGGA,الرقة
1975,3213,5,35,AL RIGGA,الرقة
1976,3213,4,39,AL RIGGA,الرقة
1977,3213,7,46,AL RIGGA,الرقة
1978,3213,1,47,AL RIGGA,الرقة
1979,3213,7,54,AL RIGGA,الرقة
1980,3213,14,68,AL RIGGA,الرقة
1981,3213,9,77,AL RIGGA,الرقة
1982,3213,13,90,AL RIGGA,الرقة
1983,3213,10,100,AL RIGGA,الرقة
1984,3213,9,109,AL RIGGA,الرقة
1985,3213,8,117,AL RIGGA,الرقة
1986,3213,9,126,AL RIGGA,الرقة
1987,3213,8,134,AL RIGGA,الرقة
1988,3213,12,146,AL RIGGA,الرقة
1989,3213,14,160,AL RIGGA,الرقة
1990,3213,28,188,AL RIGGA,الرقة
1991,3213,10,198,AL RIGGA,الرقة
1992,3213,13,211,AL RIGGA,الرقة
1993,3213,14,225,AL RIGGA,الرقة
1994,3213,19,244,AL RIGGA,الرقة
1995,3213,16,260,AL RIGGA,الرقة
1996,3213,19,279,AL RIGGA,الرقة
1997,3213,20,299,AL RIGGA,الرقة
1998,3213,25,324,AL RIGGA,الرقة
1999,3213,20,344,AL RIGGA,الرقة
2000,3213,27,371,AL RIGGA,الرقة
2001,3213,28,399,AL RIGGA,الرقة
2002,3213,45,444,AL RIGGA,الرقة
2003,3213,65,509,AL RIGGA,الرقة
2004,3213,48,557,AL RIGGA,الرقة
2005,3213,34,591,AL RIGGA,الرقة
2006,3213,45,636,AL RIGGA,الرقة
2007,3213,36,672,AL RIGGA,الرقة
2008,3213,39,711,AL RIGGA,الرقة
2009,3213,26,737,AL RIGGA,الرقة
2010,3213,36,773,AL RIGGA,الرقة
2011,3213,66,839,AL RIGGA,الرقة
2012,3213,61,900,AL RIGGA,الرقة
2013,3213,76,976,AL RIGGA,الرقة
2014,3213,76,1052,AL RIGGA,الرقة
2015,3213,80,1132,AL RIGGA,الرقة
2016,3213,79,1211,AL RIGGA,الرقة
2017,3213,89,1300,AL RIGGA,الرقة
2018,3213,101,1401,AL RIGGA,الرقة
2019,3213,168,1569,AL RIGGA,الرقة
2020,3213,323,1892,AL RIGGA,الرقة
2021,3213,0,1892,AL RIGGA,الرقة
1963,3253,0,0,AL BARSHA THIRD,البرشاء الثالثة
1964,3253,0,0,AL BARSHA THIRD,البرشاء الثالثة
1965,3253,0,0,AL BARSHA THIRD,البرشاء الثالثة
1966,3253,0,0,AL BARSHA THIRD,البرشاء الثالثة
1967,3253,0,0,AL BARSHA THIRD,البرشاء الثالثة
1968,3253,0,0,AL BARSHA THIRD,البرشاء الثالثة
1969,3253,0,0,AL BARSHA THIRD,البرشاء الثالثة
1970,3253,0,0,AL BARSHA THIRD,البرشاء الثالثة
1971,3253,0,0,AL BARSHA THIRD,البرشاء الثالثة
1972,3253,0,0,AL BARSHA THIRD,البرشاء الثالثة
1973,3253,0,0,AL BARSHA THIRD,البرشاء الثالثة
1974,3253,0,0,AL BARSHA THIRD,البرشاء الثالثة
1975,3253,0,0,AL BARSHA THIRD,البرشاء الثالثة
1976,3253,0,0,AL BARSHA THIRD,البرشاء الثالثة
1977,3253,0,0,AL BARSHA THIRD,البرشاء الثالثة
1978,3253,0,0,AL BARSHA THIRD,البرشاء الثالثة
1979,3253,0,0,AL BARSHA THIRD,البرشاء الثالثة
1980,3253,0,0,AL BARSHA THIRD,البرشاء الثالثة
1981,3253,0,0,AL BARSHA THIRD,البرشاء الثالثة
1982,3253,0,0,AL BARSHA THIRD,البرشاء الثالثة
1983,3253,0,0,AL BARSHA THIRD,البرشاء الثالثة
1984,3253,0,0,AL BARSHA THIRD,البرشاء الثالثة
1985,3253,1,1,AL BARSHA THIRD,البرشاء الثالثة
1986,3253,0,1,AL BARSHA THIRD,البرشاء الثالثة
1987,3253,0,1,AL BARSHA THIRD,البرشاء الثالثة
1988,3253,1,2,AL BARSHA THIRD,البرشاء الثالثة
1989,3253,0,2,AL BARSHA THIRD,البرشاء الثالثة
1990,3253,0,2,AL BARSHA THIRD,البرشاء الثالثة
1991,3253,0,2,AL BARSHA THIRD,البرشاء الثالثة
1992,3253,0,2,AL BARSHA THIRD,البرشاء الثالثة
1993,3253,0,2,AL BARSHA THIRD,البرشاء الثالثة
1994,3253,0,2,AL BARSHA THIRD,البرشاء الثالثة
1995,3253,0,2,AL BARSHA THIRD,البرشاء الثالثة
1996,3253,0,2,AL BARSHA THIRD,البرشاء الثالثة
1997,3253,0,2,AL BARSHA THIRD,البرشاء الثالثة
1998,3253,0,2,AL BARSHA THIRD,البرشاء الثالثة
1999,3253,1,3,AL BARSHA THIRD,البرشاء الثالثة
2000,3253,1,4,AL BARSHA THIRD,البرشاء الثالثة
2001,3253,0,4,AL BARSHA THIRD,البرشاء الثالثة
2002,3253,0,4,AL BARSHA THIRD,البرشاء الثالثة
2003,3253,3,7,AL BARSHA THIRD,البرشاء الثالثة
2004,3253,2,9,AL BARSHA THIRD,البرشاء الثالثة
2005,3253,0,9,AL BARSHA THIRD,البرشاء الثالثة
2006,3253,0,9,AL BARSHA THIRD,البرشاء الثالثة
2007,3253,2,11,AL BARSHA THIRD,البرشاء الثالثة
2008,3253,0,11,AL BARSHA THIRD,البرشاء الثالثة
2009,3253,0,11,AL BARSHA THIRD,البرشاء الثالثة
2010,3253,1,12,AL BARSHA THIRD,البرشاء الثالثة
2011,3253,0,12,AL BARSHA THIRD,البرشاء الثالثة
2012,3253,2,14,AL BARSHA THIRD,البرشاء الثالثة
2013,3253,7,21,AL BARSHA THIRD,البرشاء الثالثة
2014,3253,3,24,AL BARSHA THIRD,البرشاء الثالثة
2015,3253,4,28,AL BARSHA THIRD,البرشاء الثالثة
2016,3253,4,32,AL BARSHA THIRD,البرشاء الثالثة
2017,3253,18,50,AL BARSHA THIRD,البرشاء الثالثة
2018,3253,18,68,AL BARSHA THIRD,البرشاء الثالثة
2019,3253,37,105,AL BARSHA THIRD,البرشاء الثالثة
2020,3253,109,214,AL BARSHA THIRD,البرشاء الثالثة
2021,3253,0,214,AL BARSHA THIRD,البرشاء الثالثة
1963,3293,0,0,AL MUTEENA,المطينة
1964,3293,0,0,AL MUTEENA,المطينة
1965,3293,0,0,AL MUTEENA,المطينة
1966,3293,0,0,AL MUTEENA,المطينة
1967,3293,0,0,AL MUTEENA,المطينة
1968,3293,0,0,AL MUTEENA,المطينة
1969,3293,0,0,AL MUTEENA,المطينة
1970,3293,0,0,AL MUTEENA,المطينة
1971,3293,0,0,AL MUTEENA,المطينة
1972,3293,0,0,AL MUTEENA,المطينة
1973,3293,0,0,AL MUTEENA,المطينة
1974,3293,0,0,AL MUTEENA,المطينة
1975,3293,0,0,AL MUTEENA,المطينة
1976,3293,0,0,AL MUTEENA,المطينة
1977,3293,0,0,AL MUTEENA,المطينة
1978,3293,0,0,AL MUTEENA,المطينة
1979,3293,0,0,AL MUTEENA,المطينة
1980,3293,0,0,AL MUTEENA,المطينة
1981,3293,0,0,AL MUTEENA,المطينة
1982,3293,0,0,AL MUTEENA,المطينة
1983,3293,0,0,AL MUTEENA,المطينة
1984,3293,0,0,AL MUTEENA,المطينة
1985,3293,0,0,AL MUTEENA,المطينة
1986,3293,0,0,AL MUTEENA,المطينة
1987,3293,0,0,AL MUTEENA,المطينة
1988,3293,0,0,AL MUTEENA,المطينة
1989,3293,0,0,AL MUTEENA,المطينة
1990,3293,0,0,AL MUTEENA,المطينة
1991,3293,0,0,AL MUTEENA,المطينة
1992,3293,1,1,AL MUTEENA,المطينة
1993,3293,0,1,AL MUTEENA,المطينة
1994,3293,0,1,AL MUTEENA,المطينة
1995,3293,0,1,AL MUTEENA,المطينة
1996,3293,0,1,AL MUTEENA,المطينة
1997,3293,0,1,AL MUTEENA,المطينة
1998,3293,0,1,AL MUTEENA,المطينة
1999,3293,0,1,AL MUTEENA,المطينة
2000,3293,0,1,AL MUTEENA,المطينة
2001,3293,0,1,AL MUTEENA,المطينة
2002,3293,0,1,AL MUTEENA,المطينة
2003,3293,0,1,AL MUTEENA,المطينة
2004,3293,0,1,AL MUTEENA,المطينة
2005,3293,0,1,AL MUTEENA,المطينة
2006,3293,1,2,AL MUTEENA,المطينة
2007,3293,0,2,AL MUTEENA,المطينة
2008,3293,0,2,AL MUTEENA,المطينة
2009,3293,0,2,AL MUTEENA,المطينة
2010,3293,0,2,AL MUTEENA,المطينة
2011,3293,0,2,AL MUTEENA,المطينة
2012,3293,0,2,AL MUTEENA,المطينة
2013,3293,0,2,AL MUTEENA,المطينة
2014,3293,0,2,AL MUTEENA,المطينة
2015,3293,0,2,AL MUTEENA,المطينة
2016,3293,0,2,AL MUTEENA,المطينة
2017,3293,0,2,AL MUTEENA,المطينة
2018,3293,0,2,AL MUTEENA,المطينة
2019,3293,1,3,AL MUTEENA,المطينة
2020,3293,11,14,AL MUTEENA,المطينة
2021,3293,0,14,AL MUTEENA,المطينة
1963,3373,8,8,NAIF,نايف
1964,3373,3,11,NAIF,نايف
1965,3373,3,14,NAIF,نايف
1966,3373,2,16,NAIF,نايف
1967,3373,0,16,NAIF,نايف
1968,3373,4,20,NAIF,نايف
1969,3373,1,21,NAIF,نايف
1970,3373,2,23,NAIF,نايف
1971,3373,12,35,NAIF,نايف
1972,3373,4,39,NAIF,نايف
1973,3373,4,43,NAIF,نايف
1974,3373,4,47,NAIF,نايف
1975,3373,7,54,NAIF,نايف
1976,3373,7,61,NAIF,نايف
1977,3373,11,72,NAIF,نايف
1978,3373,12,84,NAIF,نايف
1979,3373,16,100,NAIF,نايف
1980,3373,17,117,NAIF,نايف
1981,3373,29,146,NAIF,نايف
1982,3373,19,165,NAIF,نايف
1983,3373,20,185,NAIF,نايف
1984,3373,12,197,NAIF,نايف
1985,3373,19,216,NAIF,نايف
1986,3373,25,241,NAIF,نايف
1987,3373,15,256,NAIF,نايف
1988,3373,31,287,NAIF,نايف
1989,3373,46,333,NAIF,نايف
1990,3373,25,358,NAIF,نايف
1991,3373,34,392,NAIF,نايف
1992,3373,36,428,NAIF,نايف
1993,3373,41,469,NAIF,نايف
1994,3373,52,521,NAIF,نايف
1995,3373,46,567,NAIF,نايف
1996,3373,49,616,NAIF,نايف
1997,3373,49,665,NAIF,نايف
1998,3373,57,722,NAIF,نايف
1999,3373,61,783,NAIF,نايف
2000,3373,76,859,NAIF,نايف
2001,3373,92,951,NAIF,نايف
2002,3373,108,1059,NAIF,نايف
2003,3373,123,1182,NAIF,نايف
2004,3373,145,1327,NAIF,نايف
2005,3373,121,1448,NAIF,نايف
2006,3373,156,1604,NAIF,نايف
2007,3373,171,1775,NAIF,نايف
2008,3373,159,1934,NAIF,نايف
2009,3373,121,2055,NAIF,نايف
2010,3373,180,2235,NAIF,نايف
2011,3373,225,2460,NAIF,نايف
2012,3373,226,2686,NAIF,نايف
2013,3373,242,2928,NAIF,نايف
2014,3373,231,3159,NAIF,نايف
2015,3373,221,3380,NAIF,نايف
2016,3373,197,3577,NAIF,نايف
2017,3373,202,3779,NAIF,نايف
2018,3373,193,3972,NAIF,نايف
2019,3373,294,4266,NAIF,نايف
2020,3373,417,4683,NAIF,نايف
2021,3373,0,4683,NAIF,نايف
1963,3413,2,2,AL QUSAIS SECOND,القصيص الثانية
1964,3413,1,3,AL QUSAIS SECOND,القصيص الثانية
1965,3413,0,3,AL QUSAIS SECOND,القصيص الثانية
1966,3413,0,3,AL QUSAIS SECOND,القصيص الثانية
1967,3413,2,5,AL QUSAIS SECOND,القصيص الثانية
1968,3413,0,5,AL QUSAIS SECOND,القصيص الثانية
1969,3413,1,6,AL QUSAIS SECOND,القصيص الثانية
1970,3413,2,8,AL QUSAIS SECOND,القصيص الثانية
1971,3413,0,8,AL QUSAIS SECOND,القصيص الثانية
1972,3413,1,9,AL QUSAIS SECOND,القصيص الثانية
1973,3413,0,9,AL QUSAIS SECOND,القصيص الثانية
1974,3413,1,10,AL QUSAIS SECOND,القصيص الثانية
1975,3413,3,13,AL QUSAIS SECOND,القصيص الثانية
1976,3413,0,13,AL QUSAIS SECOND,القصيص الثانية
1977,3413,0,13,AL QUSAIS SECOND,القصيص الثانية
1978,3413,2,15,AL QUSAIS SECOND,القصيص الثانية
1979,3413,1,16,AL QUSAIS SECOND,القصيص الثانية
1980,3413,2,18,AL QUSAIS SECOND,القصيص الثانية
1981,3413,1,19,AL QUSAIS SECOND,القصيص الثانية
1982,3413,0,19,AL QUSAIS SECOND,القصيص الثانية
1983,3413,1,20,AL QUSAIS SECOND,القصيص الثانية
1984,3413,1,21,AL QUSAIS SECOND,القصيص الثانية
1985,3413,1,22,AL QUSAIS SECOND,القصيص الثانية
1986,3413,2,24,AL QUSAIS SECOND,القصيص الثانية
1987,3413,2,26,AL QUSAIS SECOND,القصيص الثانية
1988,3413,3,29,AL QUSAIS SECOND,القصيص الثانية
1989,3413,2,31,AL QUSAIS SECOND,القصيص الثانية
1990,3413,3,34,AL QUSAIS SECOND,القصيص الثانية
1991,3413,2,36,AL QUSAIS SECOND,القصيص الثانية
1992,3413,5,41,AL QUSAIS SECOND,القصيص الثانية
1993,3413,5,46,AL QUSAIS SECOND,القصيص الثانية
1994,3413,5,51,AL QUSAIS SECOND,القصيص الثانية
1995,3413,6,57,AL QUSAIS SECOND,القصيص الثانية
1996,3413,1,58,AL QUSAIS SECOND,القصيص الثانية
1997,3413,7,65,AL QUSAIS SECOND,القصيص الثانية
1998,3413,5,70,AL QUSAIS SECOND,القصيص الثانية
1999,3413,3,73,AL QUSAIS SECOND,القصيص الثانية
2000,3413,4,77,AL QUSAIS SECOND,القصيص الثانية
2001,3413,4,81,AL QUSAIS SECOND,القصيص الثانية
2002,3413,11,92,AL QUSAIS SECOND,القصيص الثانية
2003,3413,19,111,AL QUSAIS SECOND,القصيص الثانية
2004,3413,13,124,AL QUSAIS SECOND,القصيص الثانية
2005,3413,21,145,AL QUSAIS SECOND,القصيص الثانية
2006,3413,17,162,AL QUSAIS SECOND,القصيص الثانية
2007,3413,20,182,AL QUSAIS SECOND,القصيص الثانية
2008,3413,24,206,AL QUSAIS SECOND,القصيص الثانية
2009,3413,18,224,AL QUSAIS SECOND,القصيص الثانية
2010,3413,24,248,AL QUSAIS SECOND,القصيص الثانية
2011,3413,27,275,AL QUSAIS SECOND,القصيص الثانية
2012,3413,24,299,AL QUSAIS SECOND,القصيص الثانية
2013,3413,39,338,AL QUSAIS SECOND,القصيص الثانية
2014,3413,50,388,AL QUSAIS SECOND,القصيص الثانية
2015,3413,60,448,AL QUSAIS SECOND,القصيص الثانية
2016,3413,67,515,AL QUSAIS SECOND,القصيص الثانية
2017,3413,55,570,AL QUSAIS SECOND,القصيص الثانية
2018,3413,70,640,AL QUSAIS SECOND,القصيص الثانية
2019,3413,147,787,AL QUSAIS SECOND,القصيص الثانية
2020,3413,212,999,AL QUSAIS SECOND,القصيص الثانية
2021,3413,0,999,AL QUSAIS SECOND,القصيص الثانية
1963,3453,0,0,AL SATWA,السطوة
1964,3453,1,1,AL SATWA,السطوة
1965,3453,1,2,AL SATWA,السطوة
1966,3453,0,2,AL SATWA,السطوة
1967,3453,0,2,AL SATWA,السطوة
1968,3453,0,2,AL SATWA,السطوة
1969,3453,0,2,AL SATWA,السطوة
1970,3453,0,2,AL SATWA,السطوة
1971,3453,2,4,AL SATWA,السطوة
1972,3453,4,8,AL SATWA,السطوة
1973,3453,3,11,AL SATWA,السطوة
1974,3453,1,12,AL SATWA,السطوة
1975,3453,3,15,AL SATWA,السطوة
1976,3453,3,18,AL SATWA,السطوة
1977,3453,4,22,AL SATWA,السطوة
1978,3453,6,28,AL SATWA,السطوة
1979,3453,5,33,AL SATWA,السطوة
1980,3453,8,41,AL SATWA,السطوة
1981,3453,4,45,AL SATWA,السطوة
1982,3453,6,51,AL SATWA,السطوة
1983,3453,7,58,AL SATWA,السطوة
1984,3453,6,64,AL SATWA,السطوة
1985,3453,8,72,AL SATWA,السطوة
1986,3453,12,84,AL SATWA,السطوة
1987,3453,6,90,AL SATWA,السطوة
1988,3453,10,100,AL SATWA,السطوة
1989,3453,10,110,AL SATWA,السطوة
1990,3453,15,125,AL SATWA,السطوة
1991,3453,8,133,AL SATWA,السطوة
1992,3453,18,151,AL SATWA,السطوة
1993,3453,11,162,AL SATWA,السطوة
1994,3453,18,180,AL SATWA,السطوة
1995,3453,7,187,AL SATWA,السطوة
1996,3453,8,195,AL SATWA,السطوة
1997,3453,16,211,AL SATWA,السطوة
1998,3453,14,225,AL SATWA,السطوة
1999,3453,14,239,AL SATWA,السطوة
2000,3453,13,252,AL SATWA,السطوة
2001,3453,7,259,AL SATWA,السطوة
2002,3453,22,281,AL SATWA,السطوة
2003,3453,22,303,AL SATWA,السطوة
2004,3453,16,319,AL SATWA,السطوة
2005,3453,15,334,AL SATWA,السطوة
2006,3453,15,349,AL SATWA,السطوة
2007,3453,17,366,AL SATWA,السطوة
2008,3453,18,384,AL SATWA,السطوة
2009,3453,18,402,AL SATWA,السطوة
2010,3453,15,417,AL SATWA,السطوة
2011,3453,22,439,AL SATWA,السطوة
2012,3453,12,451,AL SATWA,السطوة
2013,3453,12,463,AL SATWA,السطوة
2014,3453,23,486,AL SATWA,السطوة
2015,3453,15,501,AL SATWA,السطوة
2016,3453,8,509,AL SATWA,السطوة
2017,3453,30,539,AL SATWA,السطوة
2018,3453,19,558,AL SATWA,السطوة
2019,3453,45,603,AL SATWA,السطوة
2020,3453,61,664,AL SATWA,السطوة
2021,3453,0,664,AL SATWA,السطوة
1963,3533,2,2,AL QOUZ IND.FOURTH,القوز الصناعية الرابعة
1964,3533,1,3,AL QOUZ IND.FOURTH,القوز الصناعية الرابعة
1965,3533,0,3,AL QOUZ IND.FOURTH,القوز الصناعية الرابعة
1966,3533,0,3,AL QOUZ IND.FOURTH,القوز الصناعية الرابعة
1967,3533,0,3,AL QOUZ IND.FOURTH,القوز الصناعية الرابعة
1968,3533,0,3,AL QOUZ IND.FOURTH,القوز الصناعية الرابعة
1969,3533,0,3,AL QOUZ IND.FOURTH,القوز الصناعية الرابعة
1970,3533,0,3,AL QOUZ IND.FOURTH,القوز الصناعية الرابعة
1971,3533,0,3,AL QOUZ IND.FOURTH,القوز الصناعية الرابعة
1972,3533,2,5,AL QOUZ IND.FOURTH,القوز الصناعية الرابعة
1973,3533,1,6,AL QOUZ IND.FOURTH,القوز الصناعية الرابعة
1974,3533,2,8,AL QOUZ IND.FOURTH,القوز الصناعية الرابعة
1975,3533,5,13,AL QOUZ IND.FOURTH,القوز الصناعية الرابعة
1976,3533,8,21,AL QOUZ IND.FOURTH,القوز الصناعية الرابعة
1977,3533,2,23,AL QOUZ IND.FOURTH,القوز الصناعية الرابعة
1978,3533,5,28,AL QOUZ IND.FOURTH,القوز الصناعية الرابعة
1979,3533,3,31,AL QOUZ IND.FOURTH,القوز الصناعية الرابعة
1980,3533,8,39,AL QOUZ IND.FOURTH,القوز الصناعية الرابعة
1981,3533,7,46,AL QOUZ IND.FOURTH,القوز الصناعية الرابعة
1982,3533,4,50,AL QOUZ IND.FOURTH,القوز الصناعية الرابعة
1983,3533,3,53,AL QOUZ IND.FOURTH,القوز الصناعية الرابعة
1984,3533,4,57,AL QOUZ IND.FOURTH,القوز الصناعية الرابعة
1985,3533,6,63,AL QOUZ IND.FOURTH,القوز الصناعية الرابعة
1986,3533,7,70,AL QOUZ IND.FOURTH,القوز الصناعية الرابعة
1987,3533,5,75,AL QOUZ IND.FOURTH,القوز الصناعية الرابعة
1988,3533,8,83,AL QOUZ IND.FOURTH,القوز الصناعية الرابعة
1989,3533,13,96,AL QOUZ IND.FOURTH,القوز الصناعية الرابعة
1990,3533,9,105,AL QOUZ IND.FOURTH,القوز الصناعية الرابعة
1991,3533,7,112,AL QOUZ IND.FOURTH,القوز الصناعية الرابعة
1992,3533,13,125,AL QOUZ IND.FOURTH,القوز الصناعية الرابعة
1993,3533,17,142,AL QOUZ IND.FOURTH,القوز الصناعية الرابعة
1994,3533,17,159,AL QOUZ IND.FOURTH,القوز الصناعية الرابعة
1995,3533,9,168,AL QOUZ IND.FOURTH,القوز الصناعية الرابعة
1996,3533,10,178,AL QOUZ IND.FOURTH,القوز الصناعية الرابعة
1997,3533,14,192,AL QOUZ IND.FOURTH,القوز الصناعية الرابعة
1998,3533,22,214,AL QOUZ IND.FOURTH,القوز الصناعية الرابعة
1999,3533,22,236,AL QOUZ IND.FOURTH,القوز الصناعية الرابعة
2000,3533,15,251,AL QOUZ IND.FOURTH,القوز الصناعية الرابعة
2001,3533,17,268,AL QOUZ IND.FOURTH,القوز الصناعية الرابعة
2002,3533,25,293,AL QOUZ IND.FOURTH,القوز الصناعية الرابعة
2003,3533,37,330,AL QOUZ IND.FOURTH,القوز الصناعية الرابعة
2004,3533,36,366,AL QOUZ IND.FOURTH,القوز الصناعية الرابعة
2005,3533,42,408,AL QOUZ IND.FOURTH,القوز الصناعية الرابعة
2006,3533,58,466,AL QOUZ IND.FOURTH,القوز الصناعية الرابعة
2007,3533,45,511,AL QOUZ IND.FOURTH,القوز الصناعية الرابعة
2008,3533,26,537,AL QOUZ IND.FOURTH,القوز الصناعية الرابعة
2009,3533,21,558,AL QOUZ IND.FOURTH,القوز الصناعية الرابعة
2010,3533,26,584,AL QOUZ IND.FOURTH,القوز الصناعية الرابعة
2011,3533,24,608,AL QOUZ IND.FOURTH,القوز الصناعية الرابعة
2012,3533,24,632,AL QOUZ IND.FOURTH,القوز الصناعية الرابعة
2013,3533,36,668,AL QOUZ IND.FOURTH,القوز الصناعية الرابعة
2014,3533,31,699,AL QOUZ IND.FOURTH,القوز الصناعية الرابعة
2015,3533,41,740,AL QOUZ IND.FOURTH,القوز الصناعية الرابعة
2016,3533,34,774,AL QOUZ IND.FOURTH,القوز الصناعية الرابعة
2017,3533,50,824,AL QOUZ IND.FOURTH,القوز الصناعية الرابعة
2018,3533,35,859,AL QOUZ IND.FOURTH,القوز الصناعية الرابعة
2019,3533,43,902,AL QOUZ IND.FOURTH,القوز الصناعية الرابعة
2020,3533,60,962,AL QOUZ IND.FOURTH,القوز الصناعية الرابعة
2021,3533,0,962,AL QOUZ IND.FOURTH,القوز الصناعية الرابعة
1963,3573,0,0,UMM NAHAD FIRST,أم نهد الأولى
1964,3573,0,0,UMM NAHAD FIRST,أم نهد الأولى
1965,3573,0,0,UMM NAHAD FIRST,أم نهد الأولى
1966,3573,0,0,UMM NAHAD FIRST,أم نهد الأولى
1967,3573,0,0,UMM NAHAD FIRST,أم نهد الأولى
1968,3573,0,0,UMM NAHAD FIRST,أم نهد الأولى
1969,3573,0,0,UMM NAHAD FIRST,أم نهد الأولى
1970,3573,0,0,UMM NAHAD FIRST,أم نهد الأولى
1971,3573,0,0,UMM NAHAD FIRST,أم نهد الأولى
1972,3573,0,0,UMM NAHAD FIRST,أم نهد الأولى
1973,3573,0,0,UMM NAHAD FIRST,أم نهد الأولى
1974,3573,0,0,UMM NAHAD FIRST,أم نهد الأولى
1975,3573,0,0,UMM NAHAD FIRST,أم نهد الأولى
1976,3573,0,0,UMM NAHAD FIRST,أم نهد الأولى
1977,3573,0,0,UMM NAHAD FIRST,أم نهد الأولى
1978,3573,0,0,UMM NAHAD FIRST,أم نهد الأولى
1979,3573,0,0,UMM NAHAD FIRST,أم نهد الأولى
1980,3573,0,0,UMM NAHAD FIRST,أم نهد الأولى
1981,3573,0,0,UMM NAHAD FIRST,أم نهد الأولى
1982,3573,0,0,UMM NAHAD FIRST,أم نهد الأولى
1983,3573,0,0,UMM NAHAD FIRST,أم نهد الأولى
1984,3573,0,0,UMM NAHAD FIRST,أم نهد الأولى
1985,3573,0,0,UMM NAHAD FIRST,أم نهد الأولى
1986,3573,0,0,UMM NAHAD FIRST,أم نهد الأولى
1987,3573,0,0,UMM NAHAD FIRST,أم نهد الأولى
1988,3573,0,0,UMM NAHAD FIRST,أم نهد الأولى
1989,3573,0,0,UMM NAHAD FIRST,أم نهد الأولى
1990,3573,0,0,UMM NAHAD FIRST,أم نهد الأولى
1991,3573,1,1,UMM NAHAD FIRST,أم نهد الأولى
1992,3573,1,2,UMM NAHAD FIRST,أم نهد الأولى
1993,3573,1,3,UMM NAHAD FIRST,أم نهد الأولى
1994,3573,0,3,UMM NAHAD FIRST,أم نهد الأولى
1995,3573,0,3,UMM NAHAD FIRST,أم نهد الأولى
1996,3573,0,3,UMM NAHAD FIRST,أم نهد الأولى
1997,3573,1,4,UMM NAHAD FIRST,أم نهد الأولى
1998,3573,0,4,UMM NAHAD FIRST,أم نهد الأولى
1999,3573,2,6,UMM NAHAD FIRST,أم نهد الأولى
2000,3573,0,6,UMM NAHAD FIRST,أم نهد الأولى
2001,3573,1,7,UMM NAHAD FIRST,أم نهد الأولى
2002,3573,1,8,UMM NAHAD FIRST,أم نهد الأولى
2003,3573,2,10,UMM NAHAD FIRST,أم نهد الأولى
2004,3573,1,11,UMM NAHAD FIRST,أم نهد الأولى
2005,3573,0,11,UMM NAHAD FIRST,أم نهد الأولى
2006,3573,1,12,UMM NAHAD FIRST,أم نهد الأولى
2007,3573,17,29,UMM NAHAD FIRST,أم نهد الأولى
2008,3573,1,30,UMM NAHAD FIRST,أم نهد الأولى
2009,3573,1,31,UMM NAHAD FIRST,أم نهد الأولى
2010,3573,3,34,UMM NAHAD FIRST,أم نهد الأولى
2011,3573,0,34,UMM NAHAD FIRST,أم نهد الأولى
2012,3573,1,35,UMM NAHAD FIRST,أم نهد الأولى
2013,3573,4,39,UMM NAHAD FIRST,أم نهد الأولى
2014,3573,6,45,UMM NAHAD FIRST,أم نهد الأولى
2015,3573,3,48,UMM NAHAD FIRST,أم نهد الأولى
2016,3573,3,51,UMM NAHAD FIRST,أم نهد الأولى
2017,3573,5,56,UMM NAHAD FIRST,أم نهد الأولى
2018,3573,8,64,UMM NAHAD FIRST,أم نهد الأولى
2019,3573,7,71,UMM NAHAD FIRST,أم نهد الأولى
2020,3573,14,85,UMM NAHAD FIRST,أم نهد الأولى
2021,3573,0,85,UMM NAHAD FIRST,أم نهد الأولى
1963,3653,0,0,AL BARSHA SOUTH FOURTH,البرشاء جنوب الرابعة
1964,3653,0,0,AL BARSHA SOUTH FOURTH,البرشاء جنوب الرابعة
1965,3653,0,0,AL BARSHA SOUTH FOURTH,البرشاء جنوب الرابعة
1966,3653,0,0,AL BARSHA SOUTH FOURTH,البرشاء جنوب الرابعة
1967,3653,0,0,AL BARSHA SOUTH FOURTH,البرشاء جنوب الرابعة
1968,3653,0,0,AL BARSHA SOUTH FOURTH,البرشاء جنوب الرابعة
1969,3653,0,0,AL BARSHA SOUTH FOURTH,البرشاء جنوب الرابعة
1970,3653,0,0,AL BARSHA SOUTH FOURTH,البرشاء جنوب الرابعة
1971,3653,0,0,AL BARSHA SOUTH FOURTH,البرشاء جنوب الرابعة
1972,3653,0,0,AL BARSHA SOUTH FOURTH,البرشاء جنوب الرابعة
1973,3653,0,0,AL BARSHA SOUTH FOURTH,البرشاء جنوب الرابعة
1974,3653,0,0,AL BARSHA SOUTH FOURTH,البرشاء جنوب الرابعة
1975,3653,1,1,AL BARSHA SOUTH FOURTH,البرشاء جنوب الرابعة
1976,3653,0,1,AL BARSHA SOUTH FOURTH,البرشاء جنوب الرابعة
1977,3653,0,1,AL BARSHA SOUTH FOURTH,البرشاء جنوب الرابعة
1978,3653,0,1,AL BARSHA SOUTH FOURTH,البرشاء جنوب الرابعة
1979,3653,0,1,AL BARSHA SOUTH FOURTH,البرشاء جنوب الرابعة
1980,3653,0,1,AL BARSHA SOUTH FOURTH,البرشاء جنوب الرابعة
1981,3653,0,1,AL BARSHA SOUTH FOURTH,البرشاء جنوب الرابعة
1982,3653,0,1,AL BARSHA SOUTH FOURTH,البرشاء جنوب الرابعة
1983,3653,0,1,AL BARSHA SOUTH FOURTH,البرشاء جنوب الرابعة
1984,3653,0,1,AL BARSHA SOUTH FOURTH,البرشاء جنوب الرابعة
1985,3653,0,1,AL BARSHA SOUTH FOURTH,البرشاء جنوب الرابعة
1986,3653,0,1,AL BARSHA SOUTH FOURTH,البرشاء جنوب الرابعة
1987,3653,0,1,AL BARSHA SOUTH FOURTH,البرشاء جنوب الرابعة
1988,3653,0,1,AL BARSHA SOUTH FOURTH,البرشاء جنوب الرابعة
1989,3653,1,2,AL BARSHA SOUTH FOURTH,البرشاء جنوب الرابعة
1990,3653,0,2,AL BARSHA SOUTH FOURTH,البرشاء جنوب الرابعة
1991,3653,0,2,AL BARSHA SOUTH FOURTH,البرشاء جنوب الرابعة
1992,3653,0,2,AL BARSHA SOUTH FOURTH,البرشاء جنوب الرابعة
1993,3653,1,3,AL BARSHA SOUTH FOURTH,البرشاء جنوب الرابعة
1994,3653,0,3,AL BARSHA SOUTH FOURTH,البرشاء جنوب الرابعة
1995,3653,1,4,AL BARSHA SOUTH FOURTH,البرشاء جنوب الرابعة
1996,3653,1,5,AL BARSHA SOUTH FOURTH,البرشاء جنوب الرابعة
1997,3653,0,5,AL BARSHA SOUTH FOURTH,البرشاء جنوب الرابعة
1998,3653,1,6,AL BARSHA SOUTH FOURTH,البرشاء جنوب الرابعة
1999,3653,2,8,AL BARSHA SOUTH FOURTH,البرشاء جنوب الرابعة
2000,3653,3,11,AL BARSHA SOUTH FOURTH,البرشاء جنوب الرابعة
2001,3653,1,12,AL BARSHA SOUTH FOURTH,البرشاء جنوب الرابعة
2002,3653,3,15,AL BARSHA SOUTH FOURTH,البرشاء جنوب الرابعة
2003,3653,2,17,AL BARSHA SOUTH FOURTH,البرشاء جنوب الرابعة
2004,3653,1,18,AL BARSHA SOUTH FOURTH,البرشاء جنوب الرابعة
2005,3653,2,20,AL BARSHA SOUTH FOURTH,البرشاء جنوب الرابعة
2006,3653,2,22,AL BARSHA SOUTH FOURTH,البرشاء جنوب الرابعة
2007,3653,5,27,AL BARSHA SOUTH FOURTH,البرشاء جنوب الرابعة
2008,3653,1,28,AL BARSHA SOUTH FOURTH,البرشاء جنوب الرابعة
2009,3653,1,29,AL BARSHA SOUTH FOURTH,البرشاء جنوب الرابعة
2010,3653,1,30,AL BARSHA SOUTH FOURTH,البرشاء جنوب الرابعة
2011,3653,0,30,AL BARSHA SOUTH FOURTH,البرشاء جنوب الرابعة
2012,3653,6,36,AL BARSHA SOUTH FOURTH,البرشاء جنوب الرابعة
2013,3653,5,41,AL BARSHA SOUTH FOURTH,البرشاء جنوب الرابعة
2014,3653,9,50,AL BARSHA SOUTH FOURTH,البرشاء جنوب الرابعة
2015,3653,12,62,AL BARSHA SOUTH FOURTH,البرشاء جنوب الرابعة
2016,3653,12,74,AL BARSHA SOUTH FOURTH,البرشاء جنوب الرابعة
2017,3653,15,89,AL BARSHA SOUTH FOURTH,البرشاء جنوب الرابعة
2018,3653,18,107,AL BARSHA SOUTH FOURTH,البرشاء جنوب الرابعة
2019,3653,31,138,AL BARSHA SOUTH FOURTH,البرشاء جنوب الرابعة
2020,3653,83,221,AL BARSHA SOUTH FOURTH,البرشاء جنوب الرابعة
2021,3653,0,221,AL BARSHA SOUTH FOURTH,البرشاء جنوب الرابعة
1963,3693,0,0,AL KIFAF,الكفاف
1964,3693,0,0,AL KIFAF,الكفاف
1965,3693,0,0,AL KIFAF,الكفاف
1966,3693,0,0,AL KIFAF,الكفاف
1967,3693,0,0,AL KIFAF,الكفاف
1968,3693,0,0,AL KIFAF,الكفاف
1969,3693,0,0,AL KIFAF,الكفاف
1970,3693,0,0,AL KIFAF,الكفاف
1971,3693,0,0,AL KIFAF,الكفاف
1972,3693,0,0,AL KIFAF,الكفاف
1973,3693,0,0,AL KIFAF,الكفاف
1974,3693,0,0,AL KIFAF,الكفاف
1975,3693,0,0,AL KIFAF,الكفاف
1976,3693,0,0,AL KIFAF,الكفاف
1977,3693,1,1,AL KIFAF,الكفاف
1978,3693,0,1,AL KIFAF,الكفاف
1979,3693,0,1,AL KIFAF,الكفاف
1980,3693,1,2,AL KIFAF,الكفاف
1981,3693,0,2,AL KIFAF,الكفاف
1982,3693,0,2,AL KIFAF,الكفاف
1983,3693,0,2,AL KIFAF,الكفاف
1984,3693,0,2,AL KIFAF,الكفاف
1985,3693,0,2,AL KIFAF,الكفاف
1986,3693,0,2,AL KIFAF,الكفاف
1987,3693,0,2,AL KIFAF,الكفاف
1988,3693,2,4,AL KIFAF,الكفاف
1989,3693,0,4,AL KIFAF,الكفاف
1990,3693,0,4,AL KIFAF,الكفاف
1991,3693,1,5,AL KIFAF,الكفاف
1992,3693,3,8,AL KIFAF,الكفاف
1993,3693,0,8,AL KIFAF,الكفاف
1994,3693,0,8,AL KIFAF,الكفاف
1995,3693,0,8,AL KIFAF,الكفاف
1996,3693,1,9,AL KIFAF,الكفاف
1997,3693,1,10,AL KIFAF,الكفاف
1998,3693,0,10,AL KIFAF,الكفاف
1999,3693,3,13,AL KIFAF,الكفاف
2000,3693,1,14,AL KIFAF,الكفاف
2001,3693,1,15,AL KIFAF,الكفاف
2002,3693,5,20,AL KIFAF,الكفاف
2003,3693,1,21,AL KIFAF,الكفاف
2004,3693,0,21,AL KIFAF,الكفاف
2005,3693,0,21,AL KIFAF,الكفاف
2006,3693,0,21,AL KIFAF,الكفاف
2007,3693,1,22,AL KIFAF,الكفاف
2008,3693,0,22,AL KIFAF,الكفاف
2009,3693,1,23,AL KIFAF,الكفاف
2010,3693,0,23,AL KIFAF,الكفاف
2011,3693,1,24,AL KIFAF,الكفاف
2012,3693,1,25,AL KIFAF,الكفاف
2013,3693,1,26,AL KIFAF,الكفاف
2014,3693,0,26,AL KIFAF,الكفاف
2015,3693,1,27,AL KIFAF,الكفاف
2016,3693,0,27,AL KIFAF,الكفاف
2017,3693,1,28,AL KIFAF,الكفاف
2018,3693,4,32,AL KIFAF,الكفاف
2019,3693,2,34,AL KIFAF,الكفاف
2020,3693,1,35,AL KIFAF,الكفاف
2021,3693,0,35,AL KIFAF,الكفاف
1963,3733,2,2,AL NAHDA FIRST,النهدة الأولى
1964,3733,1,3,AL NAHDA FIRST,النهدة الأولى
1965,3733,0,3,AL NAHDA FIRST,النهدة الأولى
1966,3733,0,3,AL NAHDA FIRST,النهدة الأولى
1967,3733,0,3,AL NAHDA FIRST,النهدة الأولى
1968,3733,0,3,AL NAHDA FIRST,النهدة الأولى
1969,3733,0,3,AL NAHDA FIRST,النهدة الأولى
1970,3733,0,3,AL NAHDA FIRST,النهدة الأولى
1971,3733,0,3,AL NAHDA FIRST,النهدة الأولى
1972,3733,0,3,AL NAHDA FIRST,النهدة الأولى
1973,3733,0,3,AL NAHDA FIRST,النهدة الأولى
1974,3733,1,4,AL NAHDA FIRST,النهدة الأولى
1975,3733,1,5,AL NAHDA FIRST,النهدة الأولى
1976,3733,1,6,AL NAHDA FIRST,النهدة الأولى
1977,3733,2,8,AL NAHDA FIRST,النهدة الأولى
1978,3733,1,9,AL NAHDA FIRST,النهدة الأولى
1979,3733,1,10,AL NAHDA FIRST,النهدة الأولى
1980,3733,1,11,AL NAHDA FIRST,النهدة الأولى
1981,3733,1,12,AL NAHDA FIRST,النهدة الأولى
1982,3733,2,14,AL NAHDA FIRST,النهدة الأولى
1983,3733,1,15,AL NAHDA FIRST,النهدة الأولى
1984,3733,0,15,AL NAHDA FIRST,النهدة الأولى
1985,3733,2,17,AL NAHDA FIRST,النهدة الأولى
1986,3733,1,18,AL NAHDA FIRST,النهدة الأولى
1987,3733,2,20,AL NAHDA FIRST,النهدة الأولى
1988,3733,6,26,AL NAHDA FIRST,النهدة الأولى
1989,3733,3,29,AL NAHDA FIRST,النهدة الأولى
1990,3733,2,31,AL NAHDA FIRST,النهدة الأولى
1991,3733,0,31,AL NAHDA FIRST,النهدة الأولى
1992,3733,1,32,AL NAHDA FIRST,النهدة الأولى
1993,3733,1,33,AL NAHDA FIRST,النهدة الأولى
1994,3733,7,40,AL NAHDA FIRST,النهدة الأولى
1995,3733,3,43,AL NAHDA FIRST,النهدة الأولى
1996,3733,4,47,AL NAHDA FIRST,النهدة الأولى
1997,3733,5,52,AL NAHDA FIRST,النهدة الأولى
1998,3733,7,59,AL NAHDA FIRST,النهدة الأولى
1999,3733,6,65,AL NAHDA FIRST,النهدة الأولى
2000,3733,9,74,AL NAHDA FIRST,النهدة الأولى
2001,3733,13,87,AL NAHDA FIRST,النهدة الأولى
2002,3733,16,103,AL NAHDA FIRST,النهدة الأولى
2003,3733,26,129,AL NAHDA FIRST,النهدة الأولى
2004,3733,19,148,AL NAHDA FIRST,النهدة الأولى
2005,3733,25,173,AL NAHDA FIRST,النهدة الأولى
2006,3733,42,215,AL NAHDA FIRST,النهدة الأولى
2007,3733,36,251,AL NAHDA FIRST,النهدة الأولى
2008,3733,31,282,AL NAHDA FIRST,النهدة الأولى
2009,3733,19,301,AL NAHDA FIRST,النهدة الأولى
2010,3733,63,364,AL NAHDA FIRST,النهدة الأولى
2011,3733,73,437,AL NAHDA FIRST,النهدة الأولى
2012,3733,59,496,AL NAHDA FIRST,النهدة الأولى
2013,3733,77,573,AL NAHDA FIRST,النهدة الأولى
2014,3733,99,672,AL NAHDA FIRST,النهدة الأولى
2015,3733,92,764,AL NAHDA FIRST,النهدة الأولى
2016,3733,89,853,AL NAHDA FIRST,النهدة الأولى
2017,3733,91,944,AL NAHDA FIRST,النهدة الأولى
2018,3733,114,1058,AL NAHDA FIRST,النهدة الأولى
2019,3733,210,1268,AL NAHDA FIRST,النهدة الأولى
2020,3733,871,2139,AL NAHDA FIRST,النهدة الأولى
2021,3733,0,2139,AL NAHDA FIRST,النهدة الأولى
1963,3813,0,0,NADD AL SHIBA SECOND,ند الشبا الثانية
1964,3813,0,0,NADD AL SHIBA SECOND,ند الشبا الثانية
1965,3813,0,0,NADD AL SHIBA SECOND,ند الشبا الثانية
1966,3813,0,0,NADD AL SHIBA SECOND,ند الشبا الثانية
1967,3813,0,0,NADD AL SHIBA SECOND,ند الشبا الثانية
1968,3813,0,0,NADD AL SHIBA SECOND,ند الشبا الثانية
1969,3813,0,0,NADD AL SHIBA SECOND,ند الشبا الثانية
1970,3813,0,0,NADD AL SHIBA SECOND,ند الشبا الثانية
1971,3813,0,0,NADD AL SHIBA SECOND,ند الشبا الثانية
1972,3813,0,0,NADD AL SHIBA SECOND,ند الشبا الثانية
1973,3813,0,0,NADD AL SHIBA SECOND,ند الشبا الثانية
1974,3813,0,0,NADD AL SHIBA SECOND,ند الشبا الثانية
1975,3813,1,1,NADD AL SHIBA SECOND,ند الشبا الثانية
1976,3813,0,1,NADD AL SHIBA SECOND,ند الشبا الثانية
1977,3813,0,1,NADD AL SHIBA SECOND,ند الشبا الثانية
1978,3813,0,1,NADD AL SHIBA SECOND,ند الشبا الثانية
1979,3813,0,1,NADD AL SHIBA SECOND,ند الشبا الثانية
1980,3813,0,1,NADD AL SHIBA SECOND,ند الشبا الثانية
1981,3813,0,1,NADD AL SHIBA SECOND,ند الشبا الثانية
1982,3813,0,1,NADD AL SHIBA SECOND,ند الشبا الثانية
1983,3813,0,1,NADD AL SHIBA SECOND,ند الشبا الثانية
1984,3813,0,1,NADD AL SHIBA SECOND,ند الشبا الثانية
1985,3813,0,1,NADD AL SHIBA SECOND,ند الشبا الثانية
1986,3813,0,1,NADD AL SHIBA SECOND,ند الشبا الثانية
1987,3813,0,1,NADD AL SHIBA SECOND,ند الشبا الثانية
1988,3813,0,1,NADD AL SHIBA SECOND,ند الشبا الثانية
1989,3813,0,1,NADD AL SHIBA SECOND,ند الشبا الثانية
1990,3813,1,2,NADD AL SHIBA SECOND,ند الشبا الثانية
1991,3813,0,2,NADD AL SHIBA SECOND,ند الشبا الثانية
1992,3813,2,4,NADD AL SHIBA SECOND,ند الشبا الثانية
1993,3813,0,4,NADD AL SHIBA SECOND,ند الشبا الثانية
1994,3813,0,4,NADD AL SHIBA SECOND,ند الشبا الثانية
1995,3813,0,4,NADD AL SHIBA SECOND,ند الشبا الثانية
1996,3813,0,4,NADD AL SHIBA SECOND,ند الشبا الثانية
1997,3813,1,5,NADD AL SHIBA SECOND,ند الشبا الثانية
1998,3813,0,5,NADD AL SHIBA SECOND,ند الشبا الثانية
1999,3813,3,8,NADD AL SHIBA SECOND,ند الشبا الثانية
2000,3813,4,12,NADD AL SHIBA SECOND,ند الشبا الثانية
2001,3813,1,13,NADD AL SHIBA SECOND,ند الشبا الثانية
2002,3813,2,15,NADD AL SHIBA SECOND,ند الشبا الثانية
2003,3813,4,19,NADD AL SHIBA SECOND,ند الشبا الثانية
2004,3813,1,20,NADD AL SHIBA SECOND,ند الشبا الثانية
2005,3813,2,22,NADD AL SHIBA SECOND,ند الشبا الثانية
2006,3813,1,23,NADD AL SHIBA SECOND,ند الشبا الثانية
2007,3813,4,27,NADD AL SHIBA SECOND,ند الشبا الثانية
2008,3813,1,28,NADD AL SHIBA SECOND,ند الشبا الثانية
2009,3813,3,31,NADD AL SHIBA SECOND,ند الشبا الثانية
2010,3813,0,31,NADD AL SHIBA SECOND,ند الشبا الثانية
2011,3813,1,32,NADD AL SHIBA SECOND,ند الشبا الثانية
2012,3813,2,34,NADD AL SHIBA SECOND,ند الشبا الثانية
2013,3813,1,35,NADD AL SHIBA SECOND,ند الشبا الثانية
2014,3813,1,36,NADD AL SHIBA SECOND,ند الشبا الثانية
2015,3813,4,40,NADD AL SHIBA SECOND,ند الشبا الثانية
2016,3813,2,42,NADD AL SHIBA SECOND,ند الشبا الثانية
2017,3813,3,45,NADD AL SHIBA SECOND,ند الشبا الثانية
2018,3813,4,49,NADD AL SHIBA SECOND,ند الشبا الثانية
2019,3813,6,55,NADD AL SHIBA SECOND,ند الشبا الثانية
2020,3813,16,71,NADD AL SHIBA SECOND,ند الشبا الثانية
2021,3813,0,71,NADD AL SHIBA SECOND,ند الشبا الثانية
1963,3853,0,0,AL QOUZ THIRD,القوز الثالثة
1964,3853,0,0,AL QOUZ THIRD,القوز الثالثة
1965,3853,0,0,AL QOUZ THIRD,القوز الثالثة
1966,3853,0,0,AL QOUZ THIRD,القوز الثالثة
1967,3853,0,0,AL QOUZ THIRD,القوز الثالثة
1968,3853,0,0,AL QOUZ THIRD,القوز الثالثة
1969,3853,0,0,AL QOUZ THIRD,القوز الثالثة
1970,3853,0,0,AL QOUZ THIRD,القوز الثالثة
1971,3853,0,0,AL QOUZ THIRD,القوز الثالثة
1972,3853,0,0,AL QOUZ THIRD,القوز الثالثة
1973,3853,0,0,AL QOUZ THIRD,القوز الثالثة
1974,3853,0,0,AL QOUZ THIRD,القوز الثالثة
1975,3853,0,0,AL QOUZ THIRD,القوز الثالثة
1976,3853,1,1,AL QOUZ THIRD,القوز الثالثة
1977,3853,2,3,AL QOUZ THIRD,القوز الثالثة
1978,3853,0,3,AL QOUZ THIRD,القوز الثالثة
1979,3853,1,4,AL QOUZ THIRD,القوز الثالثة
1980,3853,2,6,AL QOUZ THIRD,القوز الثالثة
1981,3853,3,9,AL QOUZ THIRD,القوز الثالثة
1982,3853,0,9,AL QOUZ THIRD,القوز الثالثة
1983,3853,1,10,AL QOUZ THIRD,القوز الثالثة
1984,3853,1,11,AL QOUZ THIRD,القوز الثالثة
1985,3853,2,13,AL QOUZ THIRD,القوز الثالثة
1986,3853,0,13,AL QOUZ THIRD,القوز الثالثة
1987,3853,0,13,AL QOUZ THIRD,القوز الثالثة
1988,3853,4,17,AL QOUZ THIRD,القوز الثالثة
1989,3853,5,22,AL QOUZ THIRD,القوز الثالثة
1990,3853,3,25,AL QOUZ THIRD,القوز الثالثة
1991,3853,3,28,AL QOUZ THIRD,القوز الثالثة
1992,3853,2,30,AL QOUZ THIRD,القوز الثالثة
1993,3853,4,34,AL QOUZ THIRD,القوز الثالثة
1994,3853,1,35,AL QOUZ THIRD,القوز الثالثة
1995,3853,5,40,AL QOUZ THIRD,القوز الثالثة
1996,3853,5,45,AL QOUZ THIRD,القوز الثالثة
1997,3853,3,48,AL QOUZ THIRD,القوز الثالثة
1998,3853,5,53,AL QOUZ THIRD,القوز الثالثة
1999,3853,3,56,AL QOUZ THIRD,القوز الثالثة
2000,3853,8,64,AL QOUZ THIRD,القوز الثالثة
2001,3853,6,70,AL QOUZ THIRD,القوز الثالثة
2002,3853,9,79,AL QOUZ THIRD,القوز الثالثة
2003,3853,8,87,AL QOUZ THIRD,القوز الثالثة
2004,3853,14,101,AL QOUZ THIRD,القوز الثالثة
2005,3853,25,126,AL QOUZ THIRD,القوز الثالثة
2006,3853,12,138,AL QOUZ THIRD,القوز الثالثة
2007,3853,22,160,AL QOUZ THIRD,القوز الثالثة
2008,3853,35,195,AL QOUZ THIRD,القوز الثالثة
2009,3853,23,218,AL QOUZ THIRD,القوز الثالثة
2010,3853,25,243,AL QOUZ THIRD,القوز الثالثة
2011,3853,29,272,AL QOUZ THIRD,القوز الثالثة
2012,3853,41,313,AL QOUZ THIRD,القوز الثالثة
2013,3853,44,357,AL QOUZ THIRD,القوز الثالثة
2014,3853,51,408,AL QOUZ THIRD,القوز الثالثة
2015,3853,59,467,AL QOUZ THIRD,القوز الثالثة
2016,3853,54,521,AL QOUZ THIRD,القوز الثالثة
2017,3853,59,580,AL QOUZ THIRD,القوز الثالثة
2018,3853,50,630,AL QOUZ THIRD,القوز الثالثة
2019,3853,66,696,AL QOUZ THIRD,القوز الثالثة
2020,3853,71,767,AL QOUZ THIRD,القوز الثالثة
2021,3853,0,767,AL QOUZ THIRD,القوز الثالثة
1963,3933,0,0,"ZAA'BEEL FIRST",زعبيل الأولى
1964,3933,0,0,"ZAA'BEEL FIRST",زعبيل الأولى
1965,3933,0,0,"ZAA'BEEL FIRST",زعبيل الأولى
1966,3933,0,0,"ZAA'BEEL FIRST",زعبيل الأولى
1967,3933,0,0,"ZAA'BEEL FIRST",زعبيل الأولى
1968,3933,1,1,"ZAA'BEEL FIRST",زعبيل الأولى
1969,3933,0,1,"ZAA'BEEL FIRST",زعبيل الأولى
1970,3933,1,2,"ZAA'BEEL FIRST",زعبيل الأولى
1971,3933,0,2,"ZAA'BEEL FIRST",زعبيل الأولى
1972,3933,1,3,"ZAA'BEEL FIRST",زعبيل الأولى
1973,3933,0,3,"ZAA'BEEL FIRST",زعبيل الأولى
1974,3933,1,4,"ZAA'BEEL FIRST",زعبيل الأولى
1975,3933,0,4,"ZAA'BEEL FIRST",زعبيل الأولى
1976,3933,1,5,"ZAA'BEEL FIRST",زعبيل الأولى
1977,3933,1,6,"ZAA'BEEL FIRST",زعبيل الأولى
1978,3933,2,8,"ZAA'BEEL FIRST",زعبيل الأولى
1979,3933,1,9,"ZAA'BEEL FIRST",زعبيل الأولى
1980,3933,0,9,"ZAA'BEEL FIRST",زعبيل الأولى
1981,3933,2,11,"ZAA'BEEL FIRST",زعبيل الأولى
1982,3933,0,11,"ZAA'BEEL FIRST",زعبيل الأولى
1983,3933,0,11,"ZAA'BEEL FIRST",زعبيل الأولى
1984,3933,0,11,"ZAA'BEEL FIRST",زعبيل الأولى
1985,3933,0,11,"ZAA'BEEL FIRST",زعبيل الأولى
1986,3933,0,11,"ZAA'BEEL FIRST",زعبيل الأولى
1987,3933,1,12,"ZAA'BEEL FIRST",زعبيل الأولى
1988,3933,3,15,"ZAA'BEEL FIRST",زعبيل الأولى
1989,3933,2,17,"ZAA'BEEL FIRST",زعبيل الأولى
1990,3933,2,19,"ZAA'BEEL FIRST",زعبيل الأولى
1991,3933,3,22,"ZAA'BEEL FIRST",زعبيل الأولى
1992,3933,3,25,"ZAA'BEEL FIRST",زعبيل الأولى
1993,3933,2,27,"ZAA'BEEL FIRST",زعبيل الأولى
1994,3933,0,27,"ZAA'BEEL FIRST",زعبيل الأولى
1995,3933,0,27,"ZAA'BEEL FIRST",زعبيل الأولى
1996,3933,2,29,"ZAA'BEEL FIRST",زعبيل الأولى
1997,3933,2,31,"ZAA'BEEL FIRST",زعبيل الأولى
1998,3933,3,34,"ZAA'BEEL FIRST",زعبيل الأولى
1999,3933,2,36,"ZAA'BEEL FIRST",زعبيل الأولى
2000,3933,5,41,"ZAA'BEEL FIRST",زعبيل الأولى
2001,3933,3,44,"ZAA'BEEL FIRST",زعبيل الأولى
2002,3933,1,45,"ZAA'BEEL FIRST",زعبيل الأولى
2003,3933,3,48,"ZAA'BEEL FIRST",زعبيل الأولى
2004,3933,3,51,"ZAA'BEEL FIRST",زعبيل الأولى
2005,3933,2,53,"ZAA'BEEL FIRST",زعبيل الأولى
2006,3933,3,56,"ZAA'BEEL FIRST",زعبيل الأولى
2007,3933,8,64,"ZAA'BEEL FIRST",زعبيل الأولى
2008,3933,6,70,"ZAA'BEEL FIRST",زعبيل الأولى
2009,3933,3,73,"ZAA'BEEL FIRST",زعبيل الأولى
2010,3933,2,75,"ZAA'BEEL FIRST",زعبيل الأولى
2011,3933,4,79,"ZAA'BEEL FIRST",زعبيل الأولى
2012,3933,2,81,"ZAA'BEEL FIRST",زعبيل الأولى
2013,3933,6,87,"ZAA'BEEL FIRST",زعبيل الأولى
2014,3933,4,91,"ZAA'BEEL FIRST",زعبيل الأولى
2015,3933,4,95,"ZAA'BEEL FIRST",زعبيل الأولى
2016,3933,5,100,"ZAA'BEEL FIRST",زعبيل الأولى
2017,3933,4,104,"ZAA'BEEL FIRST",زعبيل الأولى
2018,3933,8,112,"ZAA'BEEL FIRST",زعبيل الأولى
2019,3933,10,122,"ZAA'BEEL FIRST",زعبيل الأولى
2020,3933,24,146,"ZAA'BEEL FIRST",زعبيل الأولى
2021,3933,0,146,"ZAA'BEEL FIRST",زعبيل الأولى
1963,3973,0,0,AL BARSHA SOUTH FIFTH,البرشاء جنوب الخامسة
1964,3973,0,0,AL BARSHA SOUTH FIFTH,البرشاء جنوب الخامسة
1965,3973,0,0,AL BARSHA SOUTH FIFTH,البرشاء جنوب الخامسة
1966,3973,0,0,AL BARSHA SOUTH FIFTH,البرشاء جنوب الخامسة
1967,3973,0,0,AL BARSHA SOUTH FIFTH,البرشاء جنوب الخامسة
1968,3973,0,0,AL BARSHA SOUTH FIFTH,البرشاء جنوب الخامسة
1969,3973,0,0,AL BARSHA SOUTH FIFTH,البرشاء جنوب الخامسة
1970,3973,0,0,AL BARSHA SOUTH FIFTH,البرشاء جنوب الخامسة
1971,3973,0,0,AL BARSHA SOUTH FIFTH,البرشاء جنوب الخامسة
1972,3973,0,0,AL BARSHA SOUTH FIFTH,البرشاء جنوب الخامسة
1973,3973,0,0,AL BARSHA SOUTH FIFTH,البرشاء جنوب الخامسة
1974,3973,0,0,AL BARSHA SOUTH FIFTH,البرشاء جنوب الخامسة
1975,3973,0,0,AL BARSHA SOUTH FIFTH,البرشاء جنوب الخامسة
1976,3973,0,0,AL BARSHA SOUTH FIFTH,البرشاء جنوب الخامسة
1977,3973,0,0,AL BARSHA SOUTH FIFTH,البرشاء جنوب الخامسة
1978,3973,0,0,AL BARSHA SOUTH FIFTH,البرشاء جنوب الخامسة
1979,3973,0,0,AL BARSHA SOUTH FIFTH,البرشاء جنوب الخامسة
1980,3973,0,0,AL BARSHA SOUTH FIFTH,البرشاء جنوب الخامسة
1981,3973,0,0,AL BARSHA SOUTH FIFTH,البرشاء جنوب الخامسة
1982,3973,0,0,AL BARSHA SOUTH FIFTH,البرشاء جنوب الخامسة
1983,3973,0,0,AL BARSHA SOUTH FIFTH,البرشاء جنوب الخامسة
1984,3973,0,0,AL BARSHA SOUTH FIFTH,البرشاء جنوب الخامسة
1985,3973,0,0,AL BARSHA SOUTH FIFTH,البرشاء جنوب الخامسة
1986,3973,0,0,AL BARSHA SOUTH FIFTH,البرشاء جنوب الخامسة
1987,3973,0,0,AL BARSHA SOUTH FIFTH,البرشاء جنوب الخامسة
1988,3973,0,0,AL BARSHA SOUTH FIFTH,البرشاء جنوب الخامسة
1989,3973,0,0,AL BARSHA SOUTH FIFTH,البرشاء جنوب الخامسة
1990,3973,0,0,AL BARSHA SOUTH FIFTH,البرشاء جنوب الخامسة
1991,3973,0,0,AL BARSHA SOUTH FIFTH,البرشاء جنوب الخامسة
1992,3973,0,0,AL BARSHA SOUTH FIFTH,البرشاء جنوب الخامسة
1993,3973,0,0,AL BARSHA SOUTH FIFTH,البرشاء جنوب الخامسة
1994,3973,0,0,AL BARSHA SOUTH FIFTH,البرشاء جنوب الخامسة
1995,3973,0,0,AL BARSHA SOUTH FIFTH,البرشاء جنوب الخامسة
1996,3973,0,0,AL BARSHA SOUTH FIFTH,البرشاء جنوب الخامسة
1997,3973,0,0,AL BARSHA SOUTH FIFTH,البرشاء جنوب الخامسة
1998,3973,0,0,AL BARSHA SOUTH FIFTH,البرشاء جنوب الخامسة
1999,3973,0,0,AL BARSHA SOUTH FIFTH,البرشاء جنوب الخامسة
2000,3973,0,0,AL BARSHA SOUTH FIFTH,البرشاء جنوب الخامسة
2001,3973,0,0,AL BARSHA SOUTH FIFTH,البرشاء جنوب الخامسة
2002,3973,0,0,AL BARSHA SOUTH FIFTH,البرشاء جنوب الخامسة
2003,3973,1,1,AL BARSHA SOUTH FIFTH,البرشاء جنوب الخامسة
2004,3973,0,1,AL BARSHA SOUTH FIFTH,البرشاء جنوب الخامسة
2005,3973,0,1,AL BARSHA SOUTH FIFTH,البرشاء جنوب الخامسة
2006,3973,0,1,AL BARSHA SOUTH FIFTH,البرشاء جنوب الخامسة
2007,3973,0,1,AL BARSHA SOUTH FIFTH,البرشاء جنوب الخامسة
2008,3973,0,1,AL BARSHA SOUTH FIFTH,البرشاء جنوب الخامسة
2009,3973,0,1,AL BARSHA SOUTH FIFTH,البرشاء جنوب الخامسة
2010,3973,0,1,AL BARSHA SOUTH FIFTH,البرشاء جنوب الخامسة
2011,3973,2,3,AL BARSHA SOUTH FIFTH,البرشاء جنوب الخامسة
2012,3973,2,5,AL BARSHA SOUTH FIFTH,البرشاء جنوب الخامسة
2013,3973,1,6,AL BARSHA SOUTH FIFTH,البرشاء جنوب الخامسة
2014,3973,2,8,AL BARSHA SOUTH FIFTH,البرشاء جنوب الخامسة
2015,3973,0,8,AL BARSHA SOUTH FIFTH,البرشاء جنوب الخامسة
2016,3973,1,9,AL BARSHA SOUTH FIFTH,البرشاء جنوب الخامسة
2017,3973,1,10,AL BARSHA SOUTH FIFTH,البرشاء جنوب الخامسة
2018,3973,2,12,AL BARSHA SOUTH FIFTH,البرشاء جنوب الخامسة
2019,3973,16,28,AL BARSHA SOUTH FIFTH,البرشاء جنوب الخامسة
2020,3973,21,49,AL BARSHA SOUTH FIFTH,البرشاء جنوب الخامسة
2021,3973,0,49,AL BARSHA SOUTH FIFTH,البرشاء جنوب الخامسة
1963,4053,0,0,AL QOUZ FIRST,القوز الأولى
1964,4053,1,1,AL QOUZ FIRST,القوز الأولى
1965,4053,1,2,AL QOUZ FIRST,القوز الأولى
1966,4053,0,2,AL QOUZ FIRST,القوز الأولى
1967,4053,0,2,AL QOUZ FIRST,القوز الأولى
1968,4053,1,3,AL QOUZ FIRST,القوز الأولى
1969,4053,1,4,AL QOUZ FIRST,القوز الأولى
1970,4053,0,4,AL QOUZ FIRST,القوز الأولى
1971,4053,3,7,AL QOUZ FIRST,القوز الأولى
1972,4053,1,8,AL QOUZ FIRST,القوز الأولى
1973,4053,0,8,AL QOUZ FIRST,القوز الأولى
1974,4053,0,8,AL QOUZ FIRST,القوز الأولى
1975,4053,2,10,AL QOUZ FIRST,القوز الأولى
1976,4053,2,12,AL QOUZ FIRST,القوز الأولى
1977,4053,4,16,AL QOUZ FIRST,القوز الأولى
1978,4053,2,18,AL QOUZ FIRST,القوز الأولى
1979,4053,2,20,AL QOUZ FIRST,القوز الأولى
1980,4053,2,22,AL QOUZ FIRST,القوز الأولى
1981,4053,3,25,AL QOUZ FIRST,القوز الأولى
1982,4053,1,26,AL QOUZ FIRST,القوز الأولى
1983,4053,2,28,AL QOUZ FIRST,القوز الأولى
1984,4053,0,28,AL QOUZ FIRST,القوز الأولى
1985,4053,3,31,AL QOUZ FIRST,القوز الأولى
1986,4053,7,38,AL QOUZ FIRST,القوز الأولى
1987,4053,1,39,AL QOUZ FIRST,القوز الأولى
1988,4053,4,43,AL QOUZ FIRST,القوز الأولى
1989,4053,12,55,AL QOUZ FIRST,القوز الأولى
1990,4053,7,62,AL QOUZ FIRST,القوز الأولى
1991,4053,9,71,AL QOUZ FIRST,القوز الأولى
1992,4053,11,82,AL QOUZ FIRST,القوز الأولى
1993,4053,9,91,AL QOUZ FIRST,القوز الأولى
1994,4053,10,101,AL QOUZ FIRST,القوز الأولى
1995,4053,2,103,AL QOUZ FIRST,القوز الأولى
1996,4053,7,110,AL QOUZ FIRST,القوز الأولى
1997,4053,8,118,AL QOUZ FIRST,القوز الأولى
1998,4053,13,131,AL QOUZ FIRST,القوز الأولى
1999,4053,11,142,AL QOUZ FIRST,القوز الأولى
2000,4053,20,162,AL QOUZ FIRST,القوز الأولى
2001,4053,12,174,AL QOUZ FIRST,القوز الأولى
2002,4053,15,189,AL QOUZ FIRST,القوز الأولى
2003,4053,14,203,AL QOUZ FIRST,القوز الأولى
2004,4053,25,228,AL QOUZ FIRST,القوز الأولى
2005,4053,17,245,AL QOUZ FIRST,القوز الأولى
2006,4053,36,281,AL QOUZ FIRST,القوز الأولى
2007,4053,33,314,AL QOUZ FIRST,القوز الأولى
2008,4053,42,356,AL QOUZ FIRST,القوز الأولى
2009,4053,28,384,AL QOUZ FIRST,القوز الأولى
2010,4053,61,445,AL QOUZ FIRST,القوز الأولى
2011,4053,89,534,AL QOUZ FIRST,القوز الأولى
2012,4053,71,605,AL QOUZ FIRST,القوز الأولى
2013,4053,67,672,AL QOUZ FIRST,القوز الأولى
2014,4053,66,738,AL QOUZ FIRST,القوز الأولى
2015,4053,56,794,AL QOUZ FIRST,القوز الأولى
2016,4053,52,846,AL QOUZ FIRST,القوز الأولى
2017,4053,50,896,AL QOUZ FIRST,القوز الأولى
2018,4053,61,957,AL QOUZ FIRST,القوز الأولى
2019,4053,90,1047,AL QOUZ FIRST,القوز الأولى
2020,4053,172,1219,AL QOUZ FIRST,القوز الأولى
2021,4053,0,1219,AL QOUZ FIRST,القوز الأولى
1963,4093,0,0,JABAL ALI INDUSTRIAL THIRD,جبل علي الصناعية الثالثة
1964,4093,0,0,JABAL ALI INDUSTRIAL THIRD,جبل علي الصناعية الثالثة
1965,4093,0,0,JABAL ALI INDUSTRIAL THIRD,جبل علي الصناعية الثالثة
1966,4093,0,0,JABAL ALI INDUSTRIAL THIRD,جبل علي الصناعية الثالثة
1967,4093,0,0,JABAL ALI INDUSTRIAL THIRD,جبل علي الصناعية الثالثة
1968,4093,0,0,JABAL ALI INDUSTRIAL THIRD,جبل علي الصناعية الثالثة
1969,4093,0,0,JABAL ALI INDUSTRIAL THIRD,جبل علي الصناعية الثالثة
1970,4093,0,0,JABAL ALI INDUSTRIAL THIRD,جبل علي الصناعية الثالثة
1971,4093,0,0,JABAL ALI INDUSTRIAL THIRD,جبل علي الصناعية الثالثة
1972,4093,0,0,JABAL ALI INDUSTRIAL THIRD,جبل علي الصناعية الثالثة
1973,4093,0,0,JABAL ALI INDUSTRIAL THIRD,جبل علي الصناعية الثالثة
1974,4093,0,0,JABAL ALI INDUSTRIAL THIRD,جبل علي الصناعية الثالثة
1975,4093,0,0,JABAL ALI INDUSTRIAL THIRD,جبل علي الصناعية الثالثة
1976,4093,0,0,JABAL ALI INDUSTRIAL THIRD,جبل علي الصناعية الثالثة
1977,4093,0,0,JABAL ALI INDUSTRIAL THIRD,جبل علي الصناعية الثالثة
1978,4093,2,2,JABAL ALI INDUSTRIAL THIRD,جبل علي الصناعية الثالثة
1979,4093,0,2,JABAL ALI INDUSTRIAL THIRD,جبل علي الصناعية الثالثة
1980,4093,0,2,JABAL ALI INDUSTRIAL THIRD,جبل علي الصناعية الثالثة
1981,4093,0,2,JABAL ALI INDUSTRIAL THIRD,جبل علي الصناعية الثالثة
1982,4093,1,3,JABAL ALI INDUSTRIAL THIRD,جبل علي الصناعية الثالثة
1983,4093,0,3,JABAL ALI INDUSTRIAL THIRD,جبل علي الصناعية الثالثة
1984,4093,0,3,JABAL ALI INDUSTRIAL THIRD,جبل علي الصناعية الثالثة
1985,4093,0,3,JABAL ALI INDUSTRIAL THIRD,جبل علي الصناعية الثالثة
1986,4093,0,3,JABAL ALI INDUSTRIAL THIRD,جبل علي الصناعية الثالثة
1987,4093,0,3,JABAL ALI INDUSTRIAL THIRD,جبل علي الصناعية الثالثة
1988,4093,1,4,JABAL ALI INDUSTRIAL THIRD,جبل علي الصناعية الثالثة
1989,4093,0,4,JABAL ALI INDUSTRIAL THIRD,جبل علي الصناعية الثالثة
1990,4093,0,4,JABAL ALI INDUSTRIAL THIRD,جبل علي الصناعية الثالثة
1991,4093,0,4,JABAL ALI INDUSTRIAL THIRD,جبل علي الصناعية الثالثة
1992,4093,0,4,JABAL ALI INDUSTRIAL THIRD,جبل علي الصناعية الثالثة
1993,4093,0,4,JABAL ALI INDUSTRIAL THIRD,جبل علي الصناعية الثالثة
1994,4093,1,5,JABAL ALI INDUSTRIAL THIRD,جبل علي الصناعية الثالثة
1995,4093,0,5,JABAL ALI INDUSTRIAL THIRD,جبل علي الصناعية الثالثة
1996,4093,0,5,JABAL ALI INDUSTRIAL THIRD,جبل علي الصناعية الثالثة
1997,4093,1,6,JABAL ALI INDUSTRIAL THIRD,جبل علي الصناعية الثالثة
1998,4093,0,6,JABAL ALI INDUSTRIAL THIRD,جبل علي الصناعية الثالثة
1999,4093,0,6,JABAL ALI INDUSTRIAL THIRD,جبل علي الصناعية الثالثة
2000,4093,1,7,JABAL ALI INDUSTRIAL THIRD,جبل علي الصناعية الثالثة
2001,4093,0,7,JABAL ALI INDUSTRIAL THIRD,جبل علي الصناعية الثالثة
2002,4093,2,9,JABAL ALI INDUSTRIAL THIRD,جبل علي الصناعية الثالثة
2003,4093,1,10,JABAL ALI INDUSTRIAL THIRD,جبل علي الصناعية الثالثة
2004,4093,1,11,JABAL ALI INDUSTRIAL THIRD,جبل علي الصناعية الثالثة
2005,4093,2,13,JABAL ALI INDUSTRIAL THIRD,جبل علي الصناعية الثالثة
2006,4093,3,16,JABAL ALI INDUSTRIAL THIRD,جبل علي الصناعية الثالثة
2007,4093,2,18,JABAL ALI INDUSTRIAL THIRD,جبل علي الصناعية الثالثة
2008,4093,3,21,JABAL ALI INDUSTRIAL THIRD,جبل علي الصناعية الثالثة
2009,4093,0,21,JABAL ALI INDUSTRIAL THIRD,جبل علي الصناعية الثالثة
2010,4093,2,23,JABAL ALI INDUSTRIAL THIRD,جبل علي الصناعية الثالثة
2011,4093,3,26,JABAL ALI INDUSTRIAL THIRD,جبل علي الصناعية الثالثة
2012,4093,1,27,JABAL ALI INDUSTRIAL THIRD,جبل علي الصناعية الثالثة
2013,4093,1,28,JABAL ALI INDUSTRIAL THIRD,جبل علي الصناعية الثالثة
2014,4093,4,32,JABAL ALI INDUSTRIAL THIRD,جبل علي الصناعية الثالثة
2015,4093,4,36,JABAL ALI INDUSTRIAL THIRD,جبل علي الصناعية الثالثة
2016,4093,3,39,JABAL ALI INDUSTRIAL THIRD,جبل علي الصناعية الثالثة
2017,4093,0,39,JABAL ALI INDUSTRIAL THIRD,جبل علي الصناعية الثالثة
2018,4093,3,42,JABAL ALI INDUSTRIAL THIRD,جبل علي الصناعية الثالثة
2019,4093,1,43,JABAL ALI INDUSTRIAL THIRD,جبل علي الصناعية الثالثة
2020,4093,8,51,JABAL ALI INDUSTRIAL THIRD,جبل علي الصناعية الثالثة
2021,4093,0,51,JABAL ALI INDUSTRIAL THIRD,جبل علي الصناعية الثالثة
1963,4213,0,0,"ME'AISEM SECOND",معيصم الثانية
1964,4213,0,0,"ME'AISEM SECOND",معيصم الثانية
1965,4213,0,0,"ME'AISEM SECOND",معيصم الثانية
1966,4213,0,0,"ME'AISEM SECOND",معيصم الثانية
1967,4213,0,0,"ME'AISEM SECOND",معيصم الثانية
1968,4213,0,0,"ME'AISEM SECOND",معيصم الثانية
1969,4213,0,0,"ME'AISEM SECOND",معيصم الثانية
1970,4213,0,0,"ME'AISEM SECOND",معيصم الثانية
1971,4213,0,0,"ME'AISEM SECOND",معيصم الثانية
1972,4213,0,0,"ME'AISEM SECOND",معيصم الثانية
1973,4213,0,0,"ME'AISEM SECOND",معيصم الثانية
1974,4213,0,0,"ME'AISEM SECOND",معيصم الثانية
1975,4213,0,0,"ME'AISEM SECOND",معيصم الثانية
1976,4213,0,0,"ME'AISEM SECOND",معيصم الثانية
1977,4213,0,0,"ME'AISEM SECOND",معيصم الثانية
1978,4213,0,0,"ME'AISEM SECOND",معيصم الثانية
1979,4213,0,0,"ME'AISEM SECOND",معيصم الثانية
1980,4213,0,0,"ME'AISEM SECOND",معيصم الثانية
1981,4213,0,0,"ME'AISEM SECOND",معيصم الثانية
1982,4213,0,0,"ME'AISEM SECOND",معيصم الثانية
1983,4213,0,0,"ME'AISEM SECOND",معيصم الثانية
1984,4213,0,0,"ME'AISEM SECOND",معيصم الثانية
1985,4213,0,0,"ME'AISEM SECOND",معيصم الثانية
1986,4213,0,0,"ME'AISEM SECOND",معيصم الثانية
1987,4213,0,0,"ME'AISEM SECOND",معيصم الثانية
1988,4213,0,0,"ME'AISEM SECOND",معيصم الثانية
1989,4213,0,0,"ME'AISEM SECOND",معيصم الثانية
1990,4213,0,0,"ME'AISEM SECOND",معيصم الثانية
1991,4213,0,0,"ME'AISEM SECOND",معيصم الثانية
1992,4213,0,0,"ME'AISEM SECOND",معيصم الثانية
1993,4213,0,0,"ME'AISEM SECOND",معيصم الثانية
1994,4213,0,0,"ME'AISEM SECOND",معيصم الثانية
1995,4213,0,0,"ME'AISEM SECOND",معيصم الثانية
1996,4213,0,0,"ME'AISEM SECOND",معيصم الثانية
1997,4213,0,0,"ME'AISEM SECOND",معيصم الثانية
1998,4213,0,0,"ME'AISEM SECOND",معيصم الثانية
1999,4213,0,0,"ME'AISEM SECOND",معيصم الثانية
2000,4213,0,0,"ME'AISEM SECOND",معيصم الثانية
2001,4213,0,0,"ME'AISEM SECOND",معيصم الثانية
2002,4213,0,0,"ME'AISEM SECOND",معيصم الثانية
2003,4213,0,0,"ME'AISEM SECOND",معيصم الثانية
2004,4213,0,0,"ME'AISEM SECOND",معيصم الثانية
2005,4213,0,0,"ME'AISEM SECOND",معيصم الثانية
2006,4213,0,0,"ME'AISEM SECOND",معيصم الثانية
2007,4213,0,0,"ME'AISEM SECOND",معيصم الثانية
2008,4213,0,0,"ME'AISEM SECOND",معيصم الثانية
2009,4213,0,0,"ME'AISEM SECOND",معيصم الثانية
2010,4213,0,0,"ME'AISEM SECOND",معيصم الثانية
2011,4213,0,0,"ME'AISEM SECOND",معيصم الثانية
2012,4213,0,0,"ME'AISEM SECOND",معيصم الثانية
2013,4213,0,0,"ME'AISEM SECOND",معيصم الثانية
2014,4213,0,0,"ME'AISEM SECOND",معيصم الثانية
2015,4213,0,0,"ME'AISEM SECOND",معيصم الثانية
2016,4213,0,0,"ME'AISEM SECOND",معيصم الثانية
2017,4213,0,0,"ME'AISEM SECOND",معيصم الثانية
2018,4213,2,2,"ME'AISEM SECOND",معيصم الثانية
2019,4213,2,4,"ME'AISEM SECOND",معيصم الثانية
2020,4213,8,12,"ME'AISEM SECOND",معيصم الثانية
2021,4213,0,12,"ME'AISEM SECOND",معيصم الثانية
1963,4253,1,1,AL KARAMA,الكرامة
1964,4253,0,1,AL KARAMA,الكرامة
1965,4253,0,1,AL KARAMA,الكرامة
1966,4253,0,1,AL KARAMA,الكرامة
1967,4253,0,1,AL KARAMA,الكرامة
1968,4253,0,1,AL KARAMA,الكرامة
1969,4253,0,1,AL KARAMA,الكرامة
1970,4253,1,2,AL KARAMA,الكرامة
1971,4253,1,3,AL KARAMA,الكرامة
1972,4253,1,4,AL KARAMA,الكرامة
1973,4253,2,6,AL KARAMA,الكرامة
1974,4253,1,7,AL KARAMA,الكرامة
1975,4253,3,10,AL KARAMA,الكرامة
1976,4253,4,14,AL KARAMA,الكرامة
1977,4253,3,17,AL KARAMA,الكرامة
1978,4253,2,19,AL KARAMA,الكرامة
1979,4253,4,23,AL KARAMA,الكرامة
1980,4253,11,34,AL KARAMA,الكرامة
1981,4253,28,62,AL KARAMA,الكرامة
1982,4253,11,73,AL KARAMA,الكرامة
1983,4253,5,78,AL KARAMA,الكرامة
1984,4253,6,84,AL KARAMA,الكرامة
1985,4253,5,89,AL KARAMA,الكرامة
1986,4253,9,98,AL KARAMA,الكرامة
1987,4253,9,107,AL KARAMA,الكرامة
1988,4253,14,121,AL KARAMA,الكرامة
1989,4253,15,136,AL KARAMA,الكرامة
1990,4253,30,166,AL KARAMA,الكرامة
1991,4253,17,183,AL KARAMA,الكرامة
1992,4253,21,204,AL KARAMA,الكرامة
1993,4253,27,231,AL KARAMA,الكرامة
1994,4253,26,257,AL KARAMA,الكرامة
1995,4253,14,271,AL KARAMA,الكرامة
1996,4253,26,297,AL KARAMA,الكرامة
1997,4253,30,327,AL KARAMA,الكرامة
1998,4253,19,346,AL KARAMA,الكرامة
1999,4253,24,370,AL KARAMA,الكرامة
2000,4253,26,396,AL KARAMA,الكرامة
2001,4253,48,444,AL KARAMA,الكرامة
2002,4253,54,498,AL KARAMA,الكرامة
2003,4253,59,557,AL KARAMA,الكرامة
2004,4253,69,626,AL KARAMA,الكرامة
2005,4253,51,677,AL KARAMA,الكرامة
2006,4253,69,746,AL KARAMA,الكرامة
2007,4253,63,809,AL KARAMA,الكرامة
2008,4253,54,863,AL KARAMA,الكرامة
2009,4253,39,902,AL KARAMA,الكرامة
2010,4253,58,960,AL KARAMA,الكرامة
2011,4253,86,1046,AL KARAMA,الكرامة
2012,4253,99,1145,AL KARAMA,الكرامة
2013,4253,105,1250,AL KARAMA,الكرامة
2014,4253,141,1391,AL KARAMA,الكرامة
2015,4253,136,1527,AL KARAMA,الكرامة
2016,4253,124,1651,AL KARAMA,الكرامة
2017,4253,145,1796,AL KARAMA,الكرامة
2018,4253,172,1968,AL KARAMA,الكرامة
2019,4253,187,2155,AL KARAMA,الكرامة
2020,4253,263,2418,AL KARAMA,الكرامة
2021,4253,0,2418,AL KARAMA,الكرامة
1963,4293,0,0,AL LESAILY,الليسيلي
1964,4293,0,0,AL LESAILY,الليسيلي
1965,4293,0,0,AL LESAILY,الليسيلي
1966,4293,0,0,AL LESAILY,الليسيلي
1967,4293,0,0,AL LESAILY,الليسيلي
1968,4293,0,0,AL LESAILY,الليسيلي
1969,4293,0,0,AL LESAILY,الليسيلي
1970,4293,0,0,AL LESAILY,الليسيلي
1971,4293,0,0,AL LESAILY,الليسيلي
1972,4293,0,0,AL LESAILY,الليسيلي
1973,4293,0,0,AL LESAILY,الليسيلي
1974,4293,0,0,AL LESAILY,الليسيلي
1975,4293,0,0,AL LESAILY,الليسيلي
1976,4293,0,0,AL LESAILY,الليسيلي
1977,4293,0,0,AL LESAILY,الليسيلي
1978,4293,0,0,AL LESAILY,الليسيلي
1979,4293,0,0,AL LESAILY,الليسيلي
1980,4293,2,2,AL LESAILY,الليسيلي
1981,4293,0,2,AL LESAILY,الليسيلي
1982,4293,0,2,AL LESAILY,الليسيلي
1983,4293,0,2,AL LESAILY,الليسيلي
1984,4293,1,3,AL LESAILY,الليسيلي
1985,4293,1,4,AL LESAILY,الليسيلي
1986,4293,0,4,AL LESAILY,الليسيلي
1987,4293,0,4,AL LESAILY,الليسيلي
1988,4293,0,4,AL LESAILY,الليسيلي
1989,4293,1,5,AL LESAILY,الليسيلي
1990,4293,4,9,AL LESAILY,الليسيلي
1991,4293,1,10,AL LESAILY,الليسيلي
1992,4293,2,12,AL LESAILY,الليسيلي
1993,4293,0,12,AL LESAILY,الليسيلي
1994,4293,1,13,AL LESAILY,الليسيلي
1995,4293,2,15,AL LESAILY,الليسيلي
1996,4293,4,19,AL LESAILY,الليسيلي
1997,4293,0,19,AL LESAILY,الليسيلي
1998,4293,4,23,AL LESAILY,الليسيلي
1999,4293,2,25,AL LESAILY,الليسيلي
2000,4293,4,29,AL LESAILY,الليسيلي
2001,4293,7,36,AL LESAILY,الليسيلي
2002,4293,5,41,AL LESAILY,الليسيلي
2003,4293,3,44,AL LESAILY,الليسيلي
2004,4293,7,51,AL LESAILY,الليسيلي
2005,4293,4,55,AL LESAILY,الليسيلي
2006,4293,4,59,AL LESAILY,الليسيلي
2007,4293,9,68,AL LESAILY,الليسيلي
2008,4293,2,70,AL LESAILY,الليسيلي
2009,4293,6,76,AL LESAILY,الليسيلي
2010,4293,7,83,AL LESAILY,الليسيلي
2011,4293,3,86,AL LESAILY,الليسيلي
2012,4293,7,93,AL LESAILY,الليسيلي
2013,4293,4,97,AL LESAILY,الليسيلي
2014,4293,5,102,AL LESAILY,الليسيلي
2015,4293,4,106,AL LESAILY,الليسيلي
2016,4293,5,111,AL LESAILY,الليسيلي
2017,4293,9,120,AL LESAILY,الليسيلي
2018,4293,13,133,AL LESAILY,الليسيلي
2019,4293,28,161,AL LESAILY,الليسيلي
2020,4293,39,200,AL LESAILY,الليسيلي
2021,4293,0,200,AL LESAILY,الليسيلي
1963,4333,0,0,AL SAFA SECOND,الصفا الثانية
1964,4333,0,0,AL SAFA SECOND,الصفا الثانية
1965,4333,0,0,AL SAFA SECOND,الصفا الثانية
1966,4333,0,0,AL SAFA SECOND,الصفا الثانية
1967,4333,0,0,AL SAFA SECOND,الصفا الثانية
1968,4333,0,0,AL SAFA SECOND,الصفا الثانية
1969,4333,0,0,AL SAFA SECOND,الصفا الثانية
1970,4333,0,0,AL SAFA SECOND,الصفا الثانية
1971,4333,0,0,AL SAFA SECOND,الصفا الثانية
1972,4333,0,0,AL SAFA SECOND,الصفا الثانية
1973,4333,0,0,AL SAFA SECOND,الصفا الثانية
1974,4333,0,0,AL SAFA SECOND,الصفا الثانية
1975,4333,0,0,AL SAFA SECOND,الصفا الثانية
1976,4333,0,0,AL SAFA SECOND,الصفا الثانية
1977,4333,0,0,AL SAFA SECOND,الصفا الثانية
1978,4333,0,0,AL SAFA SECOND,الصفا الثانية
1979,4333,0,0,AL SAFA SECOND,الصفا الثانية
1980,4333,0,0,AL SAFA SECOND,الصفا الثانية
1981,4333,0,0,AL SAFA SECOND,الصفا الثانية
1982,4333,0,0,AL SAFA SECOND,الصفا الثانية
1983,4333,0,0,AL SAFA SECOND,الصفا الثانية
1984,4333,0,0,AL SAFA SECOND,الصفا الثانية
1985,4333,0,0,AL SAFA SECOND,الصفا الثانية
1986,4333,0,0,AL SAFA SECOND,الصفا الثانية
1987,4333,0,0,AL SAFA SECOND,الصفا الثانية
1988,4333,0,0,AL SAFA SECOND,الصفا الثانية
1989,4333,0,0,AL SAFA SECOND,الصفا الثانية
1990,4333,0,0,AL SAFA SECOND,الصفا الثانية
1991,4333,0,0,AL SAFA SECOND,الصفا الثانية
1992,4333,0,0,AL SAFA SECOND,الصفا الثانية
1993,4333,0,0,AL SAFA SECOND,الصفا الثانية
1994,4333,0,0,AL SAFA SECOND,الصفا الثانية
1995,4333,0,0,AL SAFA SECOND,الصفا الثانية
1996,4333,0,0,AL SAFA SECOND,الصفا الثانية
1997,4333,0,0,AL SAFA SECOND,الصفا الثانية
1998,4333,0,0,AL SAFA SECOND,الصفا الثانية
1999,4333,0,0,AL SAFA SECOND,الصفا الثانية
2000,4333,0,0,AL SAFA SECOND,الصفا الثانية
2001,4333,0,0,AL SAFA SECOND,الصفا الثانية
2002,4333,0,0,AL SAFA SECOND,الصفا الثانية
2003,4333,0,0,AL SAFA SECOND,الصفا الثانية
2004,4333,0,0,AL SAFA SECOND,الصفا الثانية
2005,4333,0,0,AL SAFA SECOND,الصفا الثانية
2006,4333,0,0,AL SAFA SECOND,الصفا الثانية
2007,4333,0,0,AL SAFA SECOND,الصفا الثانية
2008,4333,0,0,AL SAFA SECOND,الصفا الثانية
2009,4333,0,0,AL SAFA SECOND,الصفا الثانية
2010,4333,0,0,AL SAFA SECOND,الصفا الثانية
2011,4333,0,0,AL SAFA SECOND,الصفا الثانية
2012,4333,0,0,AL SAFA SECOND,الصفا الثانية
2013,4333,0,0,AL SAFA SECOND,الصفا الثانية
2014,4333,0,0,AL SAFA SECOND,الصفا الثانية
2015,4333,0,0,AL SAFA SECOND,الصفا الثانية
2016,4333,0,0,AL SAFA SECOND,الصفا الثانية
2017,4333,0,0,AL SAFA SECOND,الصفا الثانية
2018,4333,0,0,AL SAFA SECOND,الصفا الثانية
2019,4333,6,6,AL SAFA SECOND,الصفا الثانية
2020,4333,23,29,AL SAFA SECOND,الصفا الثانية
2021,4333,0,29,AL SAFA SECOND,الصفا الثانية
1963,4373,0,0,AL BARSHA SOUTH FIRST,البرشاء جنوب الأولى
1964,4373,0,0,AL BARSHA SOUTH FIRST,البرشاء جنوب الأولى
1965,4373,0,0,AL BARSHA SOUTH FIRST,البرشاء جنوب الأولى
1966,4373,0,0,AL BARSHA SOUTH FIRST,البرشاء جنوب الأولى
1967,4373,0,0,AL BARSHA SOUTH FIRST,البرشاء جنوب الأولى
1968,4373,0,0,AL BARSHA SOUTH FIRST,البرشاء جنوب الأولى
1969,4373,0,0,AL BARSHA SOUTH FIRST,البرشاء جنوب الأولى
1970,4373,0,0,AL BARSHA SOUTH FIRST,البرشاء جنوب الأولى
1971,4373,0,0,AL BARSHA SOUTH FIRST,البرشاء جنوب الأولى
1972,4373,0,0,AL BARSHA SOUTH FIRST,البرشاء جنوب الأولى
1973,4373,0,0,AL BARSHA SOUTH FIRST,البرشاء جنوب الأولى
1974,4373,0,0,AL BARSHA SOUTH FIRST,البرشاء جنوب الأولى
1975,4373,0,0,AL BARSHA SOUTH FIRST,البرشاء جنوب الأولى
1976,4373,0,0,AL BARSHA SOUTH FIRST,البرشاء جنوب الأولى
1977,4373,0,0,AL BARSHA SOUTH FIRST,البرشاء جنوب الأولى
1978,4373,0,0,AL BARSHA SOUTH FIRST,البرشاء جنوب الأولى
1979,4373,0,0,AL BARSHA SOUTH FIRST,البرشاء جنوب الأولى
1980,4373,0,0,AL BARSHA SOUTH FIRST,البرشاء جنوب الأولى
1981,4373,0,0,AL BARSHA SOUTH FIRST,البرشاء جنوب الأولى
1982,4373,0,0,AL BARSHA SOUTH FIRST,البرشاء جنوب الأولى
1983,4373,0,0,AL BARSHA SOUTH FIRST,البرشاء جنوب الأولى
1984,4373,0,0,AL BARSHA SOUTH FIRST,البرشاء جنوب الأولى
1985,4373,0,0,AL BARSHA SOUTH FIRST,البرشاء جنوب الأولى
1986,4373,0,0,AL BARSHA SOUTH FIRST,البرشاء جنوب الأولى
1987,4373,0,0,AL BARSHA SOUTH FIRST,البرشاء جنوب الأولى
1988,4373,0,0,AL BARSHA SOUTH FIRST,البرشاء جنوب الأولى
1989,4373,0,0,AL BARSHA SOUTH FIRST,البرشاء جنوب الأولى
1990,4373,0,0,AL BARSHA SOUTH FIRST,البرشاء جنوب الأولى
1991,4373,0,0,AL BARSHA SOUTH FIRST,البرشاء جنوب الأولى
1992,4373,0,0,AL BARSHA SOUTH FIRST,البرشاء جنوب الأولى
1993,4373,0,0,AL BARSHA SOUTH FIRST,البرشاء جنوب الأولى
1994,4373,0,0,AL BARSHA SOUTH FIRST,البرشاء جنوب الأولى
1995,4373,0,0,AL BARSHA SOUTH FIRST,البرشاء جنوب الأولى
1996,4373,1,1,AL BARSHA SOUTH FIRST,البرشاء جنوب الأولى
1997,4373,0,1,AL BARSHA SOUTH FIRST,البرشاء جنوب الأولى
1998,4373,0,1,AL BARSHA SOUTH FIRST,البرشاء جنوب الأولى
1999,4373,0,1,AL BARSHA SOUTH FIRST,البرشاء جنوب الأولى
2000,4373,0,1,AL BARSHA SOUTH FIRST,البرشاء جنوب الأولى
2001,4373,0,1,AL BARSHA SOUTH FIRST,البرشاء جنوب الأولى
2002,4373,0,1,AL BARSHA SOUTH FIRST,البرشاء جنوب الأولى
2003,4373,1,2,AL BARSHA SOUTH FIRST,البرشاء جنوب الأولى
2004,4373,0,2,AL BARSHA SOUTH FIRST,البرشاء جنوب الأولى
2005,4373,3,5,AL BARSHA SOUTH FIRST,البرشاء جنوب الأولى
2006,4373,1,6,AL BARSHA SOUTH FIRST,البرشاء جنوب الأولى
2007,4373,0,6,AL BARSHA SOUTH FIRST,البرشاء جنوب الأولى
2008,4373,0,6,AL BARSHA SOUTH FIRST,البرشاء جنوب الأولى
2009,4373,3,9,AL BARSHA SOUTH FIRST,البرشاء جنوب الأولى
2010,4373,2,11,AL BARSHA SOUTH FIRST,البرشاء جنوب الأولى
2011,4373,0,11,AL BARSHA SOUTH FIRST,البرشاء جنوب الأولى
2012,4373,1,12,AL BARSHA SOUTH FIRST,البرشاء جنوب الأولى
2013,4373,2,14,AL BARSHA SOUTH FIRST,البرشاء جنوب الأولى
2014,4373,3,17,AL BARSHA SOUTH FIRST,البرشاء جنوب الأولى
2015,4373,4,21,AL BARSHA SOUTH FIRST,البرشاء جنوب الأولى
2016,4373,4,25,AL BARSHA SOUTH FIRST,البرشاء جنوب الأولى
2017,4373,10,35,AL BARSHA SOUTH FIRST,البرشاء جنوب الأولى
2018,4373,13,48,AL BARSHA SOUTH FIRST,البرشاء جنوب الأولى
2019,4373,26,74,AL BARSHA SOUTH FIRST,البرشاء جنوب الأولى
2020,4373,87,161,AL BARSHA SOUTH FIRST,البرشاء جنوب الأولى
2021,4373,0,161,AL BARSHA SOUTH FIRST,البرشاء جنوب الأولى
1963,4413,0,0,"AL WARQA'A FIRST",الورقاء الأولى
1964,4413,0,0,"AL WARQA'A FIRST",الورقاء الأولى
1965,4413,0,0,"AL WARQA'A FIRST",الورقاء الأولى
1966,4413,0,0,"AL WARQA'A FIRST",الورقاء الأولى
1967,4413,0,0,"AL WARQA'A FIRST",الورقاء الأولى
1968,4413,0,0,"AL WARQA'A FIRST",الورقاء الأولى
1969,4413,0,0,"AL WARQA'A FIRST",الورقاء الأولى
1970,4413,0,0,"AL WARQA'A FIRST",الورقاء الأولى
1971,4413,0,0,"AL WARQA'A FIRST",الورقاء الأولى
1972,4413,0,0,"AL WARQA'A FIRST",الورقاء الأولى
1973,4413,0,0,"AL WARQA'A FIRST",الورقاء الأولى
1974,4413,1,1,"AL WARQA'A FIRST",الورقاء الأولى
1975,4413,0,1,"AL WARQA'A FIRST",الورقاء الأولى
1976,4413,0,1,"AL WARQA'A FIRST",الورقاء الأولى
1977,4413,0,1,"AL WARQA'A FIRST",الورقاء الأولى
1978,4413,0,1,"AL WARQA'A FIRST",الورقاء الأولى
1979,4413,0,1,"AL WARQA'A FIRST",الورقاء الأولى
1980,4413,0,1,"AL WARQA'A FIRST",الورقاء الأولى
1981,4413,0,1,"AL WARQA'A FIRST",الورقاء الأولى
1982,4413,0,1,"AL WARQA'A FIRST",الورقاء الأولى
1983,4413,0,1,"AL WARQA'A FIRST",الورقاء الأولى
1984,4413,0,1,"AL WARQA'A FIRST",الورقاء الأولى
1985,4413,0,1,"AL WARQA'A FIRST",الورقاء الأولى
1986,4413,1,2,"AL WARQA'A FIRST",الورقاء الأولى
1987,4413,0,2,"AL WARQA'A FIRST",الورقاء الأولى
1988,4413,0,2,"AL WARQA'A FIRST",الورقاء الأولى
1989,4413,0,2,"AL WARQA'A FIRST",الورقاء الأولى
1990,4413,0,2,"AL WARQA'A FIRST",الورقاء الأولى
1991,4413,0,2,"AL WARQA'A FIRST",الورقاء الأولى
1992,4413,1,3,"AL WARQA'A FIRST",الورقاء الأولى
1993,4413,0,3,"AL WARQA'A FIRST",الورقاء الأولى
1994,4413,0,3,"AL WARQA'A FIRST",الورقاء الأولى
1995,4413,0,3,"AL WARQA'A FIRST",الورقاء الأولى
1996,4413,0,3,"AL WARQA'A FIRST",الورقاء الأولى
1997,4413,0,3,"AL WARQA'A FIRST",الورقاء الأولى
1998,4413,0,3,"AL WARQA'A FIRST",الورقاء الأولى
1999,4413,0,3,"AL WARQA'A FIRST",الورقاء الأولى
2000,4413,0,3,"AL WARQA'A FIRST",الورقاء الأولى
2001,4413,1,4,"AL WARQA'A FIRST",الورقاء الأولى
2002,4413,0,4,"AL WARQA'A FIRST",الورقاء الأولى
2003,4413,0,4,"AL WARQA'A FIRST",الورقاء الأولى
2004,4413,3,7,"AL WARQA'A FIRST",الورقاء الأولى
2005,4413,4,11,"AL WARQA'A FIRST",الورقاء الأولى
2006,4413,3,14,"AL WARQA'A FIRST",الورقاء الأولى
2007,4413,3,17,"AL WARQA'A FIRST",الورقاء الأولى
2008,4413,1,18,"AL WARQA'A FIRST",الورقاء الأولى
2009,4413,11,29,"AL WARQA'A FIRST",الورقاء الأولى
2010,4413,7,36,"AL WARQA'A FIRST",الورقاء الأولى
2011,4413,9,45,"AL WARQA'A FIRST",الورقاء الأولى
2012,4413,5,50,"AL WARQA'A FIRST",الورقاء الأولى
2013,4413,8,58,"AL WARQA'A FIRST",الورقاء الأولى
2014,4413,6,64,"AL WARQA'A FIRST",الورقاء الأولى
2015,4413,10,74,"AL WARQA'A FIRST",الورقاء الأولى
2016,4413,15,89,"AL WARQA'A FIRST",الورقاء الأولى
2017,4413,14,103,"AL WARQA'A FIRST",الورقاء الأولى
2018,4413,26,129,"AL WARQA'A FIRST",الورقاء الأولى
2019,4413,38,167,"AL WARQA'A FIRST",الورقاء الأولى
2020,4413,102,269,"AL WARQA'A FIRST",الورقاء الأولى
2021,4413,0,269,"AL WARQA'A FIRST",الورقاء الأولى
1963,4453,0,0,AL QUSAIS IND. THIRD,القصيص الصناعية الثالثة
1964,4453,0,0,AL QUSAIS IND. THIRD,القصيص الصناعية الثالثة
1965,4453,1,1,AL QUSAIS IND. THIRD,القصيص الصناعية الثالثة
1966,4453,1,2,AL QUSAIS IND. THIRD,القصيص الصناعية الثالثة
1967,4453,0,2,AL QUSAIS IND. THIRD,القصيص الصناعية الثالثة
1968,4453,0,2,AL QUSAIS IND. THIRD,القصيص الصناعية الثالثة
1969,4453,0,2,AL QUSAIS IND. THIRD,القصيص الصناعية الثالثة
1970,4453,1,3,AL QUSAIS IND. THIRD,القصيص الصناعية الثالثة
1971,4453,0,3,AL QUSAIS IND. THIRD,القصيص الصناعية الثالثة
1972,4453,0,3,AL QUSAIS IND. THIRD,القصيص الصناعية الثالثة
1973,4453,0,3,AL QUSAIS IND. THIRD,القصيص الصناعية الثالثة
1974,4453,1,4,AL QUSAIS IND. THIRD,القصيص الصناعية الثالثة
1975,4453,1,5,AL QUSAIS IND. THIRD,القصيص الصناعية الثالثة
1976,4453,0,5,AL QUSAIS IND. THIRD,القصيص الصناعية الثالثة
1977,4453,0,5,AL QUSAIS IND. THIRD,القصيص الصناعية الثالثة
1978,4453,0,5,AL QUSAIS IND. THIRD,القصيص الصناعية الثالثة
1979,4453,0,5,AL QUSAIS IND. THIRD,القصيص الصناعية الثالثة
1980,4453,0,5,AL QUSAIS IND. THIRD,القصيص الصناعية الثالثة
1981,4453,2,7,AL QUSAIS IND. THIRD,القصيص الصناعية الثالثة
1982,4453,1,8,AL QUSAIS IND. THIRD,القصيص الصناعية الثالثة
1983,4453,1,9,AL QUSAIS IND. THIRD,القصيص الصناعية الثالثة
1984,4453,1,10,AL QUSAIS IND. THIRD,القصيص الصناعية الثالثة
1985,4453,1,11,AL QUSAIS IND. THIRD,القصيص الصناعية الثالثة
1986,4453,0,11,AL QUSAIS IND. THIRD,القصيص الصناعية الثالثة
1987,4453,1,12,AL QUSAIS IND. THIRD,القصيص الصناعية الثالثة
1988,4453,1,13,AL QUSAIS IND. THIRD,القصيص الصناعية الثالثة
1989,4453,0,13,AL QUSAIS IND. THIRD,القصيص الصناعية الثالثة
1990,4453,1,14,AL QUSAIS IND. THIRD,القصيص الصناعية الثالثة
1991,4453,4,18,AL QUSAIS IND. THIRD,القصيص الصناعية الثالثة
1992,4453,3,21,AL QUSAIS IND. THIRD,القصيص الصناعية الثالثة
1993,4453,2,23,AL QUSAIS IND. THIRD,القصيص الصناعية الثالثة
1994,4453,1,24,AL QUSAIS IND. THIRD,القصيص الصناعية الثالثة
1995,4453,2,26,AL QUSAIS IND. THIRD,القصيص الصناعية الثالثة
1996,4453,7,33,AL QUSAIS IND. THIRD,القصيص الصناعية الثالثة
1997,4453,4,37,AL QUSAIS IND. THIRD,القصيص الصناعية الثالثة
1998,4453,4,41,AL QUSAIS IND. THIRD,القصيص الصناعية الثالثة
1999,4453,1,42,AL QUSAIS IND. THIRD,القصيص الصناعية الثالثة
2000,4453,6,48,AL QUSAIS IND. THIRD,القصيص الصناعية الثالثة
2001,4453,4,52,AL QUSAIS IND. THIRD,القصيص الصناعية الثالثة
2002,4453,4,56,AL QUSAIS IND. THIRD,القصيص الصناعية الثالثة
2003,4453,6,62,AL QUSAIS IND. THIRD,القصيص الصناعية الثالثة
2004,4453,6,68,AL QUSAIS IND. THIRD,القصيص الصناعية الثالثة
2005,4453,13,81,AL QUSAIS IND. THIRD,القصيص الصناعية الثالثة
2006,4453,12,93,AL QUSAIS IND. THIRD,القصيص الصناعية الثالثة
2007,4453,9,102,AL QUSAIS IND. THIRD,القصيص الصناعية الثالثة
2008,4453,19,121,AL QUSAIS IND. THIRD,القصيص الصناعية الثالثة
2009,4453,9,130,AL QUSAIS IND. THIRD,القصيص الصناعية الثالثة
2010,4453,10,140,AL QUSAIS IND. THIRD,القصيص الصناعية الثالثة
2011,4453,10,150,AL QUSAIS IND. THIRD,القصيص الصناعية الثالثة
2012,4453,12,162,AL QUSAIS IND. THIRD,القصيص الصناعية الثالثة
2013,4453,19,181,AL QUSAIS IND. THIRD,القصيص الصناعية الثالثة
2014,4453,18,199,AL QUSAIS IND. THIRD,القصيص الصناعية الثالثة
2015,4453,13,212,AL QUSAIS IND. THIRD,القصيص الصناعية الثالثة
2016,4453,20,232,AL QUSAIS IND. THIRD,القصيص الصناعية الثالثة
2017,4453,26,258,AL QUSAIS IND. THIRD,القصيص الصناعية الثالثة
2018,4453,27,285,AL QUSAIS IND. THIRD,القصيص الصناعية الثالثة
2019,4453,28,313,AL QUSAIS IND. THIRD,القصيص الصناعية الثالثة
2020,4453,39,352,AL QUSAIS IND. THIRD,القصيص الصناعية الثالثة
2021,4453,0,352,AL QUSAIS IND. THIRD,القصيص الصناعية الثالثة
1963,4533,0,0,AL MIZHAR FIRST,المزهر الأولى
1964,4533,0,0,AL MIZHAR FIRST,المزهر الأولى
1965,4533,0,0,AL MIZHAR FIRST,المزهر الأولى
1966,4533,0,0,AL MIZHAR FIRST,المزهر الأولى
1967,4533,0,0,AL MIZHAR FIRST,المزهر الأولى
1968,4533,0,0,AL MIZHAR FIRST,المزهر الأولى
1969,4533,0,0,AL MIZHAR FIRST,المزهر الأولى
1970,4533,0,0,AL MIZHAR FIRST,المزهر الأولى
1971,4533,0,0,AL MIZHAR FIRST,المزهر الأولى
1972,4533,0,0,AL MIZHAR FIRST,المزهر الأولى
1973,4533,0,0,AL MIZHAR FIRST,المزهر الأولى
1974,4533,0,0,AL MIZHAR FIRST,المزهر الأولى
1975,4533,0,0,AL MIZHAR FIRST,المزهر الأولى
1976,4533,0,0,AL MIZHAR FIRST,المزهر الأولى
1977,4533,0,0,AL MIZHAR FIRST,المزهر الأولى
1978,4533,0,0,AL MIZHAR FIRST,المزهر الأولى
1979,4533,0,0,AL MIZHAR FIRST,المزهر الأولى
1980,4533,0,0,AL MIZHAR FIRST,المزهر الأولى
1981,4533,0,0,AL MIZHAR FIRST,المزهر الأولى
1982,4533,0,0,AL MIZHAR FIRST,المزهر الأولى
1983,4533,0,0,AL MIZHAR FIRST,المزهر الأولى
1984,4533,0,0,AL MIZHAR FIRST,المزهر الأولى
1985,4533,2,2,AL MIZHAR FIRST,المزهر الأولى
1986,4533,2,4,AL MIZHAR FIRST,المزهر الأولى
1987,4533,1,5,AL MIZHAR FIRST,المزهر الأولى
1988,4533,0,5,AL MIZHAR FIRST,المزهر الأولى
1989,4533,0,5,AL MIZHAR FIRST,المزهر الأولى
1990,4533,0,5,AL MIZHAR FIRST,المزهر الأولى
1991,4533,1,6,AL MIZHAR FIRST,المزهر الأولى
1992,4533,1,7,AL MIZHAR FIRST,المزهر الأولى
1993,4533,0,7,AL MIZHAR FIRST,المزهر الأولى
1994,4533,0,7,AL MIZHAR FIRST,المزهر الأولى
1995,4533,1,8,AL MIZHAR FIRST,المزهر الأولى
1996,4533,0,8,AL MIZHAR FIRST,المزهر الأولى
1997,4533,2,10,AL MIZHAR FIRST,المزهر الأولى
1998,4533,2,12,AL MIZHAR FIRST,المزهر الأولى
1999,4533,2,14,AL MIZHAR FIRST,المزهر الأولى
2000,4533,2,16,AL MIZHAR FIRST,المزهر الأولى
2001,4533,3,19,AL MIZHAR FIRST,المزهر الأولى
2002,4533,4,23,AL MIZHAR FIRST,المزهر الأولى
2003,4533,6,29,AL MIZHAR FIRST,المزهر الأولى
2004,4533,7,36,AL MIZHAR FIRST,المزهر الأولى
2005,4533,6,42,AL MIZHAR FIRST,المزهر الأولى
2006,4533,1,43,AL MIZHAR FIRST,المزهر الأولى
2007,4533,5,48,AL MIZHAR FIRST,المزهر الأولى
2008,4533,8,56,AL MIZHAR FIRST,المزهر الأولى
2009,4533,17,73,AL MIZHAR FIRST,المزهر الأولى
2010,4533,15,88,AL MIZHAR FIRST,المزهر الأولى
2011,4533,7,95,AL MIZHAR FIRST,المزهر الأولى
2012,4533,10,105,AL MIZHAR FIRST,المزهر الأولى
2013,4533,11,116,AL MIZHAR FIRST,المزهر الأولى
2014,4533,12,128,AL MIZHAR FIRST,المزهر الأولى
2015,4533,14,142,AL MIZHAR FIRST,المزهر الأولى
2016,4533,11,153,AL MIZHAR FIRST,المزهر الأولى
2017,4533,27,180,AL MIZHAR FIRST,المزهر الأولى
2018,4533,21,201,AL MIZHAR FIRST,المزهر الأولى
2019,4533,46,247,AL MIZHAR FIRST,المزهر الأولى
2020,4533,141,388,AL MIZHAR FIRST,المزهر الأولى
2021,4533,0,388,AL MIZHAR FIRST,المزهر الأولى
1963,4573,0,0,UMM AL SHEIF,أم الشيف
1964,4573,0,0,UMM AL SHEIF,أم الشيف
1965,4573,0,0,UMM AL SHEIF,أم الشيف
1966,4573,0,0,UMM AL SHEIF,أم الشيف
1967,4573,0,0,UMM AL SHEIF,أم الشيف
1968,4573,1,1,UMM AL SHEIF,أم الشيف
1969,4573,0,1,UMM AL SHEIF,أم الشيف
1970,4573,0,1,UMM AL SHEIF,أم الشيف
1971,4573,0,1,UMM AL SHEIF,أم الشيف
1972,4573,0,1,UMM AL SHEIF,أم الشيف
1973,4573,0,1,UMM AL SHEIF,أم الشيف
1974,4573,1,2,UMM AL SHEIF,أم الشيف
1975,4573,1,3,UMM AL SHEIF,أم الشيف
1976,4573,0,3,UMM AL SHEIF,أم الشيف
1977,4573,0,3,UMM AL SHEIF,أم الشيف
1978,4573,0,3,UMM AL SHEIF,أم الشيف
1979,4573,1,4,UMM AL SHEIF,أم الشيف
1980,4573,0,4,UMM AL SHEIF,أم الشيف
1981,4573,0,4,UMM AL SHEIF,أم الشيف
1982,4573,0,4,UMM AL SHEIF,أم الشيف
1983,4573,0,4,UMM AL SHEIF,أم الشيف
1984,4573,1,5,UMM AL SHEIF,أم الشيف
1985,4573,0,5,UMM AL SHEIF,أم الشيف
1986,4573,0,5,UMM AL SHEIF,أم الشيف
1987,4573,0,5,UMM AL SHEIF,أم الشيف
1988,4573,0,5,UMM AL SHEIF,أم الشيف
1989,4573,0,5,UMM AL SHEIF,أم الشيف
1990,4573,0,5,UMM AL SHEIF,أم الشيف
1991,4573,0,5,UMM AL SHEIF,أم الشيف
1992,4573,1,6,UMM AL SHEIF,أم الشيف
1993,4573,0,6,UMM AL SHEIF,أم الشيف
1994,4573,1,7,UMM AL SHEIF,أم الشيف
1995,4573,0,7,UMM AL SHEIF,أم الشيف
1996,4573,0,7,UMM AL SHEIF,أم الشيف
1997,4573,2,9,UMM AL SHEIF,أم الشيف
1998,4573,0,9,UMM AL SHEIF,أم الشيف
1999,4573,0,9,UMM AL SHEIF,أم الشيف
2000,4573,0,9,UMM AL SHEIF,أم الشيف
2001,4573,1,10,UMM AL SHEIF,أم الشيف
2002,4573,1,11,UMM AL SHEIF,أم الشيف
2003,4573,2,13,UMM AL SHEIF,أم الشيف
2004,4573,1,14,UMM AL SHEIF,أم الشيف
2005,4573,6,20,UMM AL SHEIF,أم الشيف
2006,4573,1,21,UMM AL SHEIF,أم الشيف
2007,4573,2,23,UMM AL SHEIF,أم الشيف
2008,4573,1,24,UMM AL SHEIF,أم الشيف
2009,4573,4,28,UMM AL SHEIF,أم الشيف
2010,4573,1,29,UMM AL SHEIF,أم الشيف
2011,4573,4,33,UMM AL SHEIF,أم الشيف
2012,4573,6,39,UMM AL SHEIF,أم الشيف
2013,4573,19,58,UMM AL SHEIF,أم الشيف
2014,4573,3,61,UMM AL SHEIF,أم الشيف
2015,4573,7,68,UMM AL SHEIF,أم الشيف
2016,4573,13,81,UMM AL SHEIF,أم الشيف
2017,4573,23,104,UMM AL SHEIF,أم الشيف
2018,4573,20,124,UMM AL SHEIF,أم الشيف
2019,4573,28,152,UMM AL SHEIF,أم الشيف
2020,4573,34,186,UMM AL SHEIF,أم الشيف
2021,4573,0,186,UMM AL SHEIF,أم الشيف
1963,4693,0,0,MIRDIF,مردف
1964,4693,0,0,MIRDIF,مردف
1965,4693,0,0,MIRDIF,مردف
1966,4693,0,0,MIRDIF,مردف
1967,4693,0,0,MIRDIF,مردف
1968,4693,0,0,MIRDIF,مردف
1969,4693,1,1,MIRDIF,مردف
1970,4693,1,2,MIRDIF,مردف
1971,4693,0,2,MIRDIF,مردف
1972,4693,2,4,MIRDIF,مردف
1973,4693,0,4,MIRDIF,مردف
1974,4693,0,4,MIRDIF,مردف
1975,4693,0,4,MIRDIF,مردف
1976,4693,0,4,MIRDIF,مردف
1977,4693,0,4,MIRDIF,مردف
1978,4693,0,4,MIRDIF,مردف
1979,4693,0,4,MIRDIF,مردف
1980,4693,0,4,MIRDIF,مردف
1981,4693,0,4,MIRDIF,مردف
1982,4693,0,4,MIRDIF,مردف
1983,4693,2,6,MIRDIF,مردف
1984,4693,0,6,MIRDIF,مردف
1985,4693,0,6,MIRDIF,مردف
1986,4693,3,9,MIRDIF,مردف
1987,4693,0,9,MIRDIF,مردف
1988,4693,0,9,MIRDIF,مردف
1989,4693,1,10,MIRDIF,مردف
1990,4693,0,10,MIRDIF,مردف
1991,4693,2,12,MIRDIF,مردف
1992,4693,4,16,MIRDIF,مردف
1993,4693,1,17,MIRDIF,مردف
1994,4693,0,17,MIRDIF,مردف
1995,4693,1,18,MIRDIF,مردف
1996,4693,0,18,MIRDIF,مردف
1997,4693,2,20,MIRDIF,مردف
1998,4693,3,23,MIRDIF,مردف
1999,4693,4,27,MIRDIF,مردف
2000,4693,3,30,MIRDIF,مردف
2001,4693,3,33,MIRDIF,مردف
2002,4693,8,41,MIRDIF,مردف
2003,4693,9,50,MIRDIF,مردف
2004,4693,6,56,MIRDIF,مردف
2005,4693,11,67,MIRDIF,مردف
2006,4693,24,91,MIRDIF,مردف
2007,4693,19,110,MIRDIF,مردف
2008,4693,25,135,MIRDIF,مردف
2009,4693,28,163,MIRDIF,مردف
2010,4693,92,255,MIRDIF,مردف
2011,4693,64,319,MIRDIF,مردف
2012,4693,33,352,MIRDIF,مردف
2013,4693,20,372,MIRDIF,مردف
2014,4693,27,399,MIRDIF,مردف
2015,4693,21,420,MIRDIF,مردف
2016,4693,41,461,MIRDIF,مردف
2017,4693,28,489,MIRDIF,مردف
2018,4693,51,540,MIRDIF,مردف
2019,4693,71,611,MIRDIF,مردف
2020,4693,211,822,MIRDIF,مردف
2021,4693,0,822,MIRDIF,مردف
1963,4733,0,0,AL HAMRIYA PORT,ميناء الحمرية
1964,4733,0,0,AL HAMRIYA PORT,ميناء الحمرية
1965,4733,0,0,AL HAMRIYA PORT,ميناء الحمرية
1966,4733,0,0,AL HAMRIYA PORT,ميناء الحمرية
1967,4733,0,0,AL HAMRIYA PORT,ميناء الحمرية
1968,4733,0,0,AL HAMRIYA PORT,ميناء الحمرية
1969,4733,0,0,AL HAMRIYA PORT,ميناء الحمرية
1970,4733,0,0,AL HAMRIYA PORT,ميناء الحمرية
1971,4733,0,0,AL HAMRIYA PORT,ميناء الحمرية
1972,4733,0,0,AL HAMRIYA PORT,ميناء الحمرية
1973,4733,0,0,AL HAMRIYA PORT,ميناء الحمرية
1974,4733,0,0,AL HAMRIYA PORT,ميناء الحمرية
1975,4733,0,0,AL HAMRIYA PORT,ميناء الحمرية
1976,4733,0,0,AL HAMRIYA PORT,ميناء الحمرية
1977,4733,0,0,AL HAMRIYA PORT,ميناء الحمرية
1978,4733,0,0,AL HAMRIYA PORT,ميناء الحمرية
1979,4733,0,0,AL HAMRIYA PORT,ميناء الحمرية
1980,4733,0,0,AL HAMRIYA PORT,ميناء الحمرية
1981,4733,0,0,AL HAMRIYA PORT,ميناء الحمرية
1982,4733,0,0,AL HAMRIYA PORT,ميناء الحمرية
1983,4733,0,0,AL HAMRIYA PORT,ميناء الحمرية
1984,4733,0,0,AL HAMRIYA PORT,ميناء الحمرية
1985,4733,0,0,AL HAMRIYA PORT,ميناء الحمرية
1986,4733,0,0,AL HAMRIYA PORT,ميناء الحمرية
1987,4733,0,0,AL HAMRIYA PORT,ميناء الحمرية
1988,4733,0,0,AL HAMRIYA PORT,ميناء الحمرية
1989,4733,0,0,AL HAMRIYA PORT,ميناء الحمرية
1990,4733,0,0,AL HAMRIYA PORT,ميناء الحمرية
1991,4733,1,1,AL HAMRIYA PORT,ميناء الحمرية
1992,4733,0,1,AL HAMRIYA PORT,ميناء الحمرية
1993,4733,0,1,AL HAMRIYA PORT,ميناء الحمرية
1994,4733,0,1,AL HAMRIYA PORT,ميناء الحمرية
1995,4733,0,1,AL HAMRIYA PORT,ميناء الحمرية
1996,4733,1,2,AL HAMRIYA PORT,ميناء الحمرية
1997,4733,0,2,AL HAMRIYA PORT,ميناء الحمرية
1998,4733,0,2,AL HAMRIYA PORT,ميناء الحمرية
1999,4733,0,2,AL HAMRIYA PORT,ميناء الحمرية
2000,4733,1,3,AL HAMRIYA PORT,ميناء الحمرية
2001,4733,0,3,AL HAMRIYA PORT,ميناء الحمرية
2002,4733,0,3,AL HAMRIYA PORT,ميناء الحمرية
2003,4733,1,4,AL HAMRIYA PORT,ميناء الحمرية
2004,4733,1,5,AL HAMRIYA PORT,ميناء الحمرية
2005,4733,1,6,AL HAMRIYA PORT,ميناء الحمرية
2006,4733,2,8,AL HAMRIYA PORT,ميناء الحمرية
2007,4733,1,9,AL HAMRIYA PORT,ميناء الحمرية
2008,4733,1,10,AL HAMRIYA PORT,ميناء الحمرية
2009,4733,0,10,AL HAMRIYA PORT,ميناء الحمرية
2010,4733,2,12,AL HAMRIYA PORT,ميناء الحمرية
2011,4733,0,12,AL HAMRIYA PORT,ميناء الحمرية
2012,4733,0,12,AL HAMRIYA PORT,ميناء الحمرية
2013,4733,2,14,AL HAMRIYA PORT,ميناء الحمرية
2014,4733,2,16,AL HAMRIYA PORT,ميناء الحمرية
2015,4733,2,18,AL HAMRIYA PORT,ميناء الحمرية
2016,4733,0,18,AL HAMRIYA PORT,ميناء الحمرية
2017,4733,2,20,AL HAMRIYA PORT,ميناء الحمرية
2018,4733,2,22,AL HAMRIYA PORT,ميناء الحمرية
2019,4733,4,26,AL HAMRIYA PORT,ميناء الحمرية
2020,4733,6,32,AL HAMRIYA PORT,ميناء الحمرية
2021,4733,0,32,AL HAMRIYA PORT,ميناء الحمرية
1963,4773,2,2,OUD AL MUTEENA THIRD,عود المطينة الثالثة
1964,4773,0,2,OUD AL MUTEENA THIRD,عود المطينة الثالثة
1965,4773,1,3,OUD AL MUTEENA THIRD,عود المطينة الثالثة
1966,4773,1,4,OUD AL MUTEENA THIRD,عود المطينة الثالثة
1967,4773,0,4,OUD AL MUTEENA THIRD,عود المطينة الثالثة
1968,4773,2,6,OUD AL MUTEENA THIRD,عود المطينة الثالثة
1969,4773,0,6,OUD AL MUTEENA THIRD,عود المطينة الثالثة
1970,4773,1,7,OUD AL MUTEENA THIRD,عود المطينة الثالثة
1971,4773,1,8,OUD AL MUTEENA THIRD,عود المطينة الثالثة
1972,4773,1,9,OUD AL MUTEENA THIRD,عود المطينة الثالثة
1973,4773,1,10,OUD AL MUTEENA THIRD,عود المطينة الثالثة
1974,4773,1,11,OUD AL MUTEENA THIRD,عود المطينة الثالثة
1975,4773,1,12,OUD AL MUTEENA THIRD,عود المطينة الثالثة
1976,4773,1,13,OUD AL MUTEENA THIRD,عود المطينة الثالثة
1977,4773,3,16,OUD AL MUTEENA THIRD,عود المطينة الثالثة
1978,4773,6,22,OUD AL MUTEENA THIRD,عود المطينة الثالثة
1979,4773,1,23,OUD AL MUTEENA THIRD,عود المطينة الثالثة
1980,4773,2,25,OUD AL MUTEENA THIRD,عود المطينة الثالثة
1981,4773,0,25,OUD AL MUTEENA THIRD,عود المطينة الثالثة
1982,4773,9,34,OUD AL MUTEENA THIRD,عود المطينة الثالثة
1983,4773,1,35,OUD AL MUTEENA THIRD,عود المطينة الثالثة
1984,4773,3,38,OUD AL MUTEENA THIRD,عود المطينة الثالثة
1985,4773,4,42,OUD AL MUTEENA THIRD,عود المطينة الثالثة
1986,4773,0,42,OUD AL MUTEENA THIRD,عود المطينة الثالثة
1987,4773,2,44,OUD AL MUTEENA THIRD,عود المطينة الثالثة
1988,4773,9,53,OUD AL MUTEENA THIRD,عود المطينة الثالثة
1989,4773,7,60,OUD AL MUTEENA THIRD,عود المطينة الثالثة
1990,4773,9,69,OUD AL MUTEENA THIRD,عود المطينة الثالثة
1991,4773,10,79,OUD AL MUTEENA THIRD,عود المطينة الثالثة
1992,4773,11,90,OUD AL MUTEENA THIRD,عود المطينة الثالثة
1993,4773,6,96,OUD AL MUTEENA THIRD,عود المطينة الثالثة
1994,4773,8,104,OUD AL MUTEENA THIRD,عود المطينة الثالثة
1995,4773,6,110,OUD AL MUTEENA THIRD,عود المطينة الثالثة
1996,4773,14,124,OUD AL MUTEENA THIRD,عود المطينة الثالثة
1997,4773,8,132,OUD AL MUTEENA THIRD,عود المطينة الثالثة
1998,4773,7,139,OUD AL MUTEENA THIRD,عود المطينة الثالثة
1999,4773,17,156,OUD AL MUTEENA THIRD,عود المطينة الثالثة
2000,4773,18,174,OUD AL MUTEENA THIRD,عود المطينة الثالثة
2001,4773,13,187,OUD AL MUTEENA THIRD,عود المطينة الثالثة
2002,4773,21,208,OUD AL MUTEENA THIRD,عود المطينة الثالثة
2003,4773,24,232,OUD AL MUTEENA THIRD,عود المطينة الثالثة
2004,4773,20,252,OUD AL MUTEENA THIRD,عود المطينة الثالثة
2005,4773,20,272,OUD AL MUTEENA THIRD,عود المطينة الثالثة
2006,4773,26,298,OUD AL MUTEENA THIRD,عود المطينة الثالثة
2007,4773,34,332,OUD AL MUTEENA THIRD,عود المطينة الثالثة
2008,4773,34,366,OUD AL MUTEENA THIRD,عود المطينة الثالثة
2009,4773,15,381,OUD AL MUTEENA THIRD,عود المطينة الثالثة
2010,4773,26,407,OUD AL MUTEENA THIRD,عود المطينة الثالثة
2011,4773,41,448,OUD AL MUTEENA THIRD,عود المطينة الثالثة
2012,4773,48,496,OUD AL MUTEENA THIRD,عود المطينة الثالثة
2013,4773,40,536,OUD AL MUTEENA THIRD,عود المطينة الثالثة
2014,4773,48,584,OUD AL MUTEENA THIRD,عود المطينة الثالثة
2015,4773,60,644,OUD AL MUTEENA THIRD,عود المطينة الثالثة
2016,4773,70,714,OUD AL MUTEENA THIRD,عود المطينة الثالثة
2017,4773,61,775,OUD AL MUTEENA THIRD,عود المطينة الثالثة
2018,4773,81,856,OUD AL MUTEENA THIRD,عود المطينة الثالثة
2019,4773,239,1095,OUD AL MUTEENA THIRD,عود المطينة الثالثة
2020,4773,1032,2127,OUD AL MUTEENA THIRD,عود المطينة الثالثة
2021,4773,0,2127,OUD AL MUTEENA THIRD,عود المطينة الثالثة
1963,4813,0,0,WADI AL SAFA 2,وادي الصفا 2
1964,4813,0,0,WADI AL SAFA 2,وادي الصفا 2
1965,4813,0,0,WADI AL SAFA 2,وادي الصفا 2
1966,4813,0,0,WADI AL SAFA 2,وادي الصفا 2
1967,4813,0,0,WADI AL SAFA 2,وادي الصفا 2
1968,4813,0,0,WADI AL SAFA 2,وادي الصفا 2
1969,4813,0,0,WADI AL SAFA 2,وادي الصفا 2
1970,4813,0,0,WADI AL SAFA 2,وادي الصفا 2
1971,4813,0,0,WADI AL SAFA 2,وادي الصفا 2
1972,4813,1,1,WADI AL SAFA 2,وادي الصفا 2
1973,4813,0,1,WADI AL SAFA 2,وادي الصفا 2
1974,4813,0,1,WADI AL SAFA 2,وادي الصفا 2
1975,4813,0,1,WADI AL SAFA 2,وادي الصفا 2
1976,4813,0,1,WADI AL SAFA 2,وادي الصفا 2
1977,4813,0,1,WADI AL SAFA 2,وادي الصفا 2
1978,4813,0,1,WADI AL SAFA 2,وادي الصفا 2
1979,4813,0,1,WADI AL SAFA 2,وادي الصفا 2
1980,4813,0,1,WADI AL SAFA 2,وادي الصفا 2
1981,4813,1,2,WADI AL SAFA 2,وادي الصفا 2
1982,4813,0,2,WADI AL SAFA 2,وادي الصفا 2
1983,4813,0,2,WADI AL SAFA 2,وادي الصفا 2
1984,4813,0,2,WADI AL SAFA 2,وادي الصفا 2
1985,4813,0,2,WADI AL SAFA 2,وادي الصفا 2
1986,4813,0,2,WADI AL SAFA 2,وادي الصفا 2
1987,4813,0,2,WADI AL SAFA 2,وادي الصفا 2
1988,4813,0,2,WADI AL SAFA 2,وادي الصفا 2
1989,4813,0,2,WADI AL SAFA 2,وادي الصفا 2
1990,4813,0,2,WADI AL SAFA 2,وادي الصفا 2
1991,4813,0,2,WADI AL SAFA 2,وادي الصفا 2
1992,4813,1,3,WADI AL SAFA 2,وادي الصفا 2
1993,4813,1,4,WADI AL SAFA 2,وادي الصفا 2
1994,4813,1,5,WADI AL SAFA 2,وادي الصفا 2
1995,4813,0,5,WADI AL SAFA 2,وادي الصفا 2
1996,4813,1,6,WADI AL SAFA 2,وادي الصفا 2
1997,4813,2,8,WADI AL SAFA 2,وادي الصفا 2
1998,4813,1,9,WADI AL SAFA 2,وادي الصفا 2
1999,4813,0,9,WADI AL SAFA 2,وادي الصفا 2
2000,4813,0,9,WADI AL SAFA 2,وادي الصفا 2
2001,4813,1,10,WADI AL SAFA 2,وادي الصفا 2
2002,4813,1,11,WADI AL SAFA 2,وادي الصفا 2
2003,4813,1,12,WADI AL SAFA 2,وادي الصفا 2
2004,4813,1,13,WADI AL SAFA 2,وادي الصفا 2
2005,4813,2,15,WADI AL SAFA 2,وادي الصفا 2
2006,4813,1,16,WADI AL SAFA 2,وادي الصفا 2
2007,4813,1,17,WADI AL SAFA 2,وادي الصفا 2
2008,4813,1,18,WADI AL SAFA 2,وادي الصفا 2
2009,4813,0,18,WADI AL SAFA 2,وادي الصفا 2
2010,4813,3,21,WADI AL SAFA 2,وادي الصفا 2
2011,4813,6,27,WADI AL SAFA 2,وادي الصفا 2
2012,4813,6,33,WADI AL SAFA 2,وادي الصفا 2
2013,4813,8,41,WADI AL SAFA 2,وادي الصفا 2
2014,4813,9,50,WADI AL SAFA 2,وادي الصفا 2
2015,4813,7,57,WADI AL SAFA 2,وادي الصفا 2
2016,4813,8,65,WADI AL SAFA 2,وادي الصفا 2
2017,4813,4,69,WADI AL SAFA 2,وادي الصفا 2
2018,4813,8,77,WADI AL SAFA 2,وادي الصفا 2
2019,4813,18,95,WADI AL SAFA 2,وادي الصفا 2
2020,4813,31,126,WADI AL SAFA 2,وادي الصفا 2
2021,4813,0,126,WADI AL SAFA 2,وادي الصفا 2
1963,4893,1,1,RAS AL KHOR IND. THIRD,رأس الخور الصناعية الثالثة
1964,4893,0,1,RAS AL KHOR IND. THIRD,رأس الخور الصناعية الثالثة
1965,4893,0,1,RAS AL KHOR IND. THIRD,رأس الخور الصناعية الثالثة
1966,4893,0,1,RAS AL KHOR IND. THIRD,رأس الخور الصناعية الثالثة
1967,4893,0,1,RAS AL KHOR IND. THIRD,رأس الخور الصناعية الثالثة
1968,4893,0,1,RAS AL KHOR IND. THIRD,رأس الخور الصناعية الثالثة
1969,4893,0,1,RAS AL KHOR IND. THIRD,رأس الخور الصناعية الثالثة
1970,4893,0,1,RAS AL KHOR IND. THIRD,رأس الخور الصناعية الثالثة
1971,4893,2,3,RAS AL KHOR IND. THIRD,رأس الخور الصناعية الثالثة
1972,4893,1,4,RAS AL KHOR IND. THIRD,رأس الخور الصناعية الثالثة
1973,4893,1,5,RAS AL KHOR IND. THIRD,رأس الخور الصناعية الثالثة
1974,4893,0,5,RAS AL KHOR IND. THIRD,رأس الخور الصناعية الثالثة
1975,4893,1,6,RAS AL KHOR IND. THIRD,رأس الخور الصناعية الثالثة
1976,4893,1,7,RAS AL KHOR IND. THIRD,رأس الخور الصناعية الثالثة
1977,4893,1,8,RAS AL KHOR IND. THIRD,رأس الخور الصناعية الثالثة
1978,4893,2,10,RAS AL KHOR IND. THIRD,رأس الخور الصناعية الثالثة
1979,4893,2,12,RAS AL KHOR IND. THIRD,رأس الخور الصناعية الثالثة
1980,4893,1,13,RAS AL KHOR IND. THIRD,رأس الخور الصناعية الثالثة
1981,4893,10,23,RAS AL KHOR IND. THIRD,رأس الخور الصناعية الثالثة
1982,4893,5,28,RAS AL KHOR IND. THIRD,رأس الخور الصناعية الثالثة
1983,4893,1,29,RAS AL KHOR IND. THIRD,رأس الخور الصناعية الثالثة
1984,4893,0,29,RAS AL KHOR IND. THIRD,رأس الخور الصناعية الثالثة
1985,4893,3,32,RAS AL KHOR IND. THIRD,رأس الخور الصناعية الثالثة
1986,4893,5,37,RAS AL KHOR IND. THIRD,رأس الخور الصناعية الثالثة
1987,4893,2,39,RAS AL KHOR IND. THIRD,رأس الخور الصناعية الثالثة
1988,4893,2,41,RAS AL KHOR IND. THIRD,رأس الخور الصناعية الثالثة
1989,4893,8,49,RAS AL KHOR IND. THIRD,رأس الخور الصناعية الثالثة
1990,4893,8,57,RAS AL KHOR IND. THIRD,رأس الخور الصناعية الثالثة
1991,4893,12,69,RAS AL KHOR IND. THIRD,رأس الخور الصناعية الثالثة
1992,4893,3,72,RAS AL KHOR IND. THIRD,رأس الخور الصناعية الثالثة
1993,4893,13,85,RAS AL KHOR IND. THIRD,رأس الخور الصناعية الثالثة
1994,4893,8,93,RAS AL KHOR IND. THIRD,رأس الخور الصناعية الثالثة
1995,4893,11,104,RAS AL KHOR IND. THIRD,رأس الخور الصناعية الثالثة
1996,4893,8,112,RAS AL KHOR IND. THIRD,رأس الخور الصناعية الثالثة
1997,4893,4,116,RAS AL KHOR IND. THIRD,رأس الخور الصناعية الثالثة
1998,4893,8,124,RAS AL KHOR IND. THIRD,رأس الخور الصناعية الثالثة
1999,4893,14,138,RAS AL KHOR IND. THIRD,رأس الخور الصناعية الثالثة
2000,4893,12,150,RAS AL KHOR IND. THIRD,رأس الخور الصناعية الثالثة
2001,4893,13,163,RAS AL KHOR IND. THIRD,رأس الخور الصناعية الثالثة
2002,4893,12,175,RAS AL KHOR IND. THIRD,رأس الخور الصناعية الثالثة
2003,4893,18,193,RAS AL KHOR IND. THIRD,رأس الخور الصناعية الثالثة
2004,4893,33,226,RAS AL KHOR IND. THIRD,رأس الخور الصناعية الثالثة
2005,4893,18,244,RAS AL KHOR IND. THIRD,رأس الخور الصناعية الثالثة
2006,4893,27,271,RAS AL KHOR IND. THIRD,رأس الخور الصناعية الثالثة
2007,4893,30,301,RAS AL KHOR IND. THIRD,رأس الخور الصناعية الثالثة
2008,4893,22,323,RAS AL KHOR IND. THIRD,رأس الخور الصناعية الثالثة
2009,4893,20,343,RAS AL KHOR IND. THIRD,رأس الخور الصناعية الثالثة
2010,4893,29,372,RAS AL KHOR IND. THIRD,رأس الخور الصناعية الثالثة
2011,4893,39,411,RAS AL KHOR IND. THIRD,رأس الخور الصناعية الثالثة
2012,4893,22,433,RAS AL KHOR IND. THIRD,رأس الخور الصناعية الثالثة
2013,4893,36,469,RAS AL KHOR IND. THIRD,رأس الخور الصناعية الثالثة
2014,4893,49,518,RAS AL KHOR IND. THIRD,رأس الخور الصناعية الثالثة
2015,4893,47,565,RAS AL KHOR IND. THIRD,رأس الخور الصناعية الثالثة
2016,4893,46,611,RAS AL KHOR IND. THIRD,رأس الخور الصناعية الثالثة
2017,4893,54,665,RAS AL KHOR IND. THIRD,رأس الخور الصناعية الثالثة
2018,4893,63,728,RAS AL KHOR IND. THIRD,رأس الخور الصناعية الثالثة
2019,4893,98,826,RAS AL KHOR IND. THIRD,رأس الخور الصناعية الثالثة
2020,4893,240,1066,RAS AL KHOR IND. THIRD,رأس الخور الصناعية الثالثة
2021,4893,0,1066,RAS AL KHOR IND. THIRD,رأس الخور الصناعية الثالثة
1963,5133,0,0,BU KADRA,بو كدرة
1964,5133,0,0,BU KADRA,بو كدرة
1965,5133,0,0,BU KADRA,بو كدرة
1966,5133,0,0,BU KADRA,بو كدرة
1967,5133,0,0,BU KADRA,بو كدرة
1968,5133,0,0,BU KADRA,بو كدرة
1969,5133,0,0,BU KADRA,بو كدرة
1970,5133,0,0,BU KADRA,بو كدرة
1971,5133,0,0,BU KADRA,بو كدرة
1972,5133,0,0,BU KADRA,بو كدرة
1973,5133,0,0,BU KADRA,بو كدرة
1974,5133,0,0,BU KADRA,بو كدرة
1975,5133,0,0,BU KADRA,بو كدرة
1976,5133,0,0,BU KADRA,بو كدرة
1977,5133,0,0,BU KADRA,بو كدرة
1978,5133,0,0,BU KADRA,بو كدرة
1979,5133,0,0,BU KADRA,بو كدرة
1980,5133,0,0,BU KADRA,بو كدرة
1981,5133,0,0,BU KADRA,بو كدرة
1982,5133,0,0,BU KADRA,بو كدرة
1983,5133,0,0,BU KADRA,بو كدرة
1984,5133,0,0,BU KADRA,بو كدرة
1985,5133,0,0,BU KADRA,بو كدرة
1986,5133,0,0,BU KADRA,بو كدرة
1987,5133,0,0,BU KADRA,بو كدرة
1988,5133,0,0,BU KADRA,بو كدرة
1989,5133,0,0,BU KADRA,بو كدرة
1990,5133,0,0,BU KADRA,بو كدرة
1991,5133,0,0,BU KADRA,بو كدرة
1992,5133,0,0,BU KADRA,بو كدرة
1993,5133,0,0,BU KADRA,بو كدرة
1994,5133,0,0,BU KADRA,بو كدرة
1995,5133,0,0,BU KADRA,بو كدرة
1996,5133,0,0,BU KADRA,بو كدرة
1997,5133,0,0,BU KADRA,بو كدرة
1998,5133,0,0,BU KADRA,بو كدرة
1999,5133,0,0,BU KADRA,بو كدرة
2000,5133,0,0,BU KADRA,بو كدرة
2001,5133,0,0,BU KADRA,بو كدرة
2002,5133,0,0,BU KADRA,بو كدرة
2003,5133,0,0,BU KADRA,بو كدرة
2004,5133,0,0,BU KADRA,بو كدرة
2005,5133,0,0,BU KADRA,بو كدرة
2006,5133,0,0,BU KADRA,بو كدرة
2007,5133,2,2,BU KADRA,بو كدرة
2008,5133,0,2,BU KADRA,بو كدرة
2009,5133,0,2,BU KADRA,بو كدرة
2010,5133,0,2,BU KADRA,بو كدرة
2011,5133,0,2,BU KADRA,بو كدرة
2012,5133,1,3,BU KADRA,بو كدرة
2013,5133,2,5,BU KADRA,بو كدرة
2014,5133,0,5,BU KADRA,بو كدرة
2015,5133,1,6,BU KADRA,بو كدرة
2016,5133,0,6,BU KADRA,بو كدرة
2017,5133,2,8,BU KADRA,بو كدرة
2018,5133,0,8,BU KADRA,بو كدرة
2019,5133,2,10,BU KADRA,بو كدرة
2020,5133,2,12,BU KADRA,بو كدرة
2021,5133,0,12,BU KADRA,بو كدرة
1963,5213,1,1,AL GARHOUD,القرهود
1964,5213,0,1,AL GARHOUD,القرهود
1965,5213,0,1,AL GARHOUD,القرهود
1966,5213,0,1,AL GARHOUD,القرهود
1967,5213,0,1,AL GARHOUD,القرهود
1968,5213,2,3,AL GARHOUD,القرهود
1969,5213,0,3,AL GARHOUD,القرهود
1970,5213,0,3,AL GARHOUD,القرهود
1971,5213,0,3,AL GARHOUD,القرهود
1972,5213,1,4,AL GARHOUD,القرهود
1973,5213,4,8,AL GARHOUD,القرهود
1974,5213,6,14,AL GARHOUD,القرهود
1975,5213,1,15,AL GARHOUD,القرهود
1976,5213,6,21,AL GARHOUD,القرهود
1977,5213,10,31,AL GARHOUD,القرهود
1978,5213,6,37,AL GARHOUD,القرهود
1979,5213,5,42,AL GARHOUD,القرهود
1980,5213,12,54,AL GARHOUD,القرهود
1981,5213,7,61,AL GARHOUD,القرهود
1982,5213,9,70,AL GARHOUD,القرهود
1983,5213,3,73,AL GARHOUD,القرهود
1984,5213,3,76,AL GARHOUD,القرهود
1985,5213,2,78,AL GARHOUD,القرهود
1986,5213,4,82,AL GARHOUD,القرهود
1987,5213,11,93,AL GARHOUD,القرهود
1988,5213,11,104,AL GARHOUD,القرهود
1989,5213,9,113,AL GARHOUD,القرهود
1990,5213,12,125,AL GARHOUD,القرهود
1991,5213,14,139,AL GARHOUD,القرهود
1992,5213,15,154,AL GARHOUD,القرهود
1993,5213,17,171,AL GARHOUD,القرهود
1994,5213,14,185,AL GARHOUD,القرهود
1995,5213,18,203,AL GARHOUD,القرهود
1996,5213,14,217,AL GARHOUD,القرهود
1997,5213,29,246,AL GARHOUD,القرهود
1998,5213,23,269,AL GARHOUD,القرهود
1999,5213,22,291,AL GARHOUD,القرهود
2000,5213,17,308,AL GARHOUD,القرهود
2001,5213,22,330,AL GARHOUD,القرهود
2002,5213,31,361,AL GARHOUD,القرهود
2003,5213,59,420,AL GARHOUD,القرهود
2004,5213,59,479,AL GARHOUD,القرهود
2005,5213,59,538,AL GARHOUD,القرهود
2006,5213,90,628,AL GARHOUD,القرهود
2007,5213,80,708,AL GARHOUD,القرهود
2008,5213,71,779,AL GARHOUD,القرهود
2009,5213,52,831,AL GARHOUD,القرهود
2010,5213,69,900,AL GARHOUD,القرهود
2011,5213,109,1009,AL GARHOUD,القرهود
2012,5213,97,1106,AL GARHOUD,القرهود
2013,5213,149,1255,AL GARHOUD,القرهود
2014,5213,174,1429,AL GARHOUD,القرهود
2015,5213,175,1604,AL GARHOUD,القرهود
2016,5213,199,1803,AL GARHOUD,القرهود
2017,5213,208,2011,AL GARHOUD,القرهود
2018,5213,240,2251,AL GARHOUD,القرهود
2019,5213,484,2735,AL GARHOUD,القرهود
2020,5213,2291,5026,AL GARHOUD,القرهود
2021,5213,0,5026,AL GARHOUD,القرهود
1963,5253,0,0,UMM HURAIR FIRST,أم هرير الأولى
1964,5253,0,0,UMM HURAIR FIRST,أم هرير الأولى
1965,5253,0,0,UMM HURAIR FIRST,أم هرير الأولى
1966,5253,0,0,UMM HURAIR FIRST,أم هرير الأولى
1967,5253,0,0,UMM HURAIR FIRST,أم هرير الأولى
1968,5253,0,0,UMM HURAIR FIRST,أم هرير الأولى
1969,5253,0,0,UMM HURAIR FIRST,أم هرير الأولى
1970,5253,0,0,UMM HURAIR FIRST,أم هرير الأولى
1971,5253,0,0,UMM HURAIR FIRST,أم هرير الأولى
1972,5253,0,0,UMM HURAIR FIRST,أم هرير الأولى
1973,5253,0,0,UMM HURAIR FIRST,أم هرير الأولى
1974,5253,0,0,UMM HURAIR FIRST,أم هرير الأولى
1975,5253,1,1,UMM HURAIR FIRST,أم هرير الأولى
1976,5253,0,1,UMM HURAIR FIRST,أم هرير الأولى
1977,5253,2,3,UMM HURAIR FIRST,أم هرير الأولى
1978,5253,1,4,UMM HURAIR FIRST,أم هرير الأولى
1979,5253,0,4,UMM HURAIR FIRST,أم هرير الأولى
1980,5253,2,6,UMM HURAIR FIRST,أم هرير الأولى
1981,5253,0,6,UMM HURAIR FIRST,أم هرير الأولى
1982,5253,1,7,UMM HURAIR FIRST,أم هرير الأولى
1983,5253,1,8,UMM HURAIR FIRST,أم هرير الأولى
1984,5253,2,10,UMM HURAIR FIRST,أم هرير الأولى
1985,5253,0,10,UMM HURAIR FIRST,أم هرير الأولى
1986,5253,1,11,UMM HURAIR FIRST,أم هرير الأولى
1987,5253,0,11,UMM HURAIR FIRST,أم هرير الأولى
1988,5253,4,15,UMM HURAIR FIRST,أم هرير الأولى
1989,5253,4,19,UMM HURAIR FIRST,أم هرير الأولى
1990,5253,3,22,UMM HURAIR FIRST,أم هرير الأولى
1991,5253,3,25,UMM HURAIR FIRST,أم هرير الأولى
1992,5253,1,26,UMM HURAIR FIRST,أم هرير الأولى
1993,5253,4,30,UMM HURAIR FIRST,أم هرير الأولى
1994,5253,3,33,UMM HURAIR FIRST,أم هرير الأولى
1995,5253,2,35,UMM HURAIR FIRST,أم هرير الأولى
1996,5253,2,37,UMM HURAIR FIRST,أم هرير الأولى
1997,5253,4,41,UMM HURAIR FIRST,أم هرير الأولى
1998,5253,3,44,UMM HURAIR FIRST,أم هرير الأولى
1999,5253,3,47,UMM HURAIR FIRST,أم هرير الأولى
2000,5253,7,54,UMM HURAIR FIRST,أم هرير الأولى
2001,5253,9,63,UMM HURAIR FIRST,أم هرير الأولى
2002,5253,7,70,UMM HURAIR FIRST,أم هرير الأولى
2003,5253,20,90,UMM HURAIR FIRST,أم هرير الأولى
2004,5253,9,99,UMM HURAIR FIRST,أم هرير الأولى
2005,5253,5,104,UMM HURAIR FIRST,أم هرير الأولى
2006,5253,6,110,UMM HURAIR FIRST,أم هرير الأولى
2007,5253,10,120,UMM HURAIR FIRST,أم هرير الأولى
2008,5253,12,132,UMM HURAIR FIRST,أم هرير الأولى
2009,5253,3,135,UMM HURAIR FIRST,أم هرير الأولى
2010,5253,8,143,UMM HURAIR FIRST,أم هرير الأولى
2011,5253,5,148,UMM HURAIR FIRST,أم هرير الأولى
2012,5253,6,154,UMM HURAIR FIRST,أم هرير الأولى
2013,5253,9,163,UMM HURAIR FIRST,أم هرير الأولى
2014,5253,10,173,UMM HURAIR FIRST,أم هرير الأولى
2015,5253,10,183,UMM HURAIR FIRST,أم هرير الأولى
2016,5253,12,195,UMM HURAIR FIRST,أم هرير الأولى
2017,5253,15,210,UMM HURAIR FIRST,أم هرير الأولى
2018,5253,14,224,UMM HURAIR FIRST,أم هرير الأولى
2019,5253,16,240,UMM HURAIR FIRST,أم هرير الأولى
2020,5253,29,269,UMM HURAIR FIRST,أم هرير الأولى
2021,5253,0,269,UMM HURAIR FIRST,أم هرير الأولى
1963,5293,0,0,NADD SHAMMA,ند شما
1964,5293,0,0,NADD SHAMMA,ند شما
1965,5293,0,0,NADD SHAMMA,ند شما
1966,5293,0,0,NADD SHAMMA,ند شما
1967,5293,0,0,NADD SHAMMA,ند شما
1968,5293,0,0,NADD SHAMMA,ند شما
1969,5293,0,0,NADD SHAMMA,ند شما
1970,5293,0,0,NADD SHAMMA,ند شما
1971,5293,0,0,NADD SHAMMA,ند شما
1972,5293,0,0,NADD SHAMMA,ند شما
1973,5293,0,0,NADD SHAMMA,ند شما
1974,5293,0,0,NADD SHAMMA,ند شما
1975,5293,0,0,NADD SHAMMA,ند شما
1976,5293,0,0,NADD SHAMMA,ند شما
1977,5293,0,0,NADD SHAMMA,ند شما
1978,5293,0,0,NADD SHAMMA,ند شما
1979,5293,0,0,NADD SHAMMA,ند شما
1980,5293,0,0,NADD SHAMMA,ند شما
1981,5293,0,0,NADD SHAMMA,ند شما
1982,5293,0,0,NADD SHAMMA,ند شما
1983,5293,0,0,NADD SHAMMA,ند شما
1984,5293,0,0,NADD SHAMMA,ند شما
1985,5293,0,0,NADD SHAMMA,ند شما
1986,5293,0,0,NADD SHAMMA,ند شما
1987,5293,0,0,NADD SHAMMA,ند شما
1988,5293,0,0,NADD SHAMMA,ند شما
1989,5293,0,0,NADD SHAMMA,ند شما
1990,5293,0,0,NADD SHAMMA,ند شما
1991,5293,1,1,NADD SHAMMA,ند شما
1992,5293,1,2,NADD SHAMMA,ند شما
1993,5293,0,2,NADD SHAMMA,ند شما
1994,5293,0,2,NADD SHAMMA,ند شما
1995,5293,0,2,NADD SHAMMA,ند شما
1996,5293,1,3,NADD SHAMMA,ند شما
1997,5293,0,3,NADD SHAMMA,ند شما
1998,5293,0,3,NADD SHAMMA,ند شما
1999,5293,1,4,NADD SHAMMA,ند شما
2000,5293,0,4,NADD SHAMMA,ند شما
2001,5293,0,4,NADD SHAMMA,ند شما
2002,5293,0,4,NADD SHAMMA,ند شما
2003,5293,1,5,NADD SHAMMA,ند شما
2004,5293,0,5,NADD SHAMMA,ند شما
2005,5293,0,5,NADD SHAMMA,ند شما
2006,5293,1,6,NADD SHAMMA,ند شما
2007,5293,0,6,NADD SHAMMA,ند شما
2008,5293,1,7,NADD SHAMMA,ند شما
2009,5293,0,7,NADD SHAMMA,ند شما
2010,5293,2,9,NADD SHAMMA,ند شما
2011,5293,2,11,NADD SHAMMA,ند شما
2012,5293,1,12,NADD SHAMMA,ند شما
2013,5293,1,13,NADD SHAMMA,ند شما
2014,5293,2,15,NADD SHAMMA,ند شما
2015,5293,2,17,NADD SHAMMA,ند شما
2016,5293,4,21,NADD SHAMMA,ند شما
2017,5293,6,27,NADD SHAMMA,ند شما
2018,5293,5,32,NADD SHAMMA,ند شما
2019,5293,5,37,NADD SHAMMA,ند شما
2020,5293,13,50,NADD SHAMMA,ند شما
2021,5293,0,50,NADD SHAMMA,ند شما
1963,5333,0,0,AL QOUZ SECOND,القوز الثانية
1964,5333,0,0,AL QOUZ SECOND,القوز الثانية
1965,5333,0,0,AL QOUZ SECOND,القوز الثانية
1966,5333,0,0,AL QOUZ SECOND,القوز الثانية
1967,5333,0,0,AL QOUZ SECOND,القوز الثانية
1968,5333,0,0,AL QOUZ SECOND,القوز الثانية
1969,5333,0,0,AL QOUZ SECOND,القوز الثانية
1970,5333,0,0,AL QOUZ SECOND,القوز الثانية
1971,5333,0,0,AL QOUZ SECOND,القوز الثانية
1972,5333,0,0,AL QOUZ SECOND,القوز الثانية
1973,5333,0,0,AL QOUZ SECOND,القوز الثانية
1974,5333,1,1,AL QOUZ SECOND,القوز الثانية
1975,5333,0,1,AL QOUZ SECOND,القوز الثانية
1976,5333,0,1,AL QOUZ SECOND,القوز الثانية
1977,5333,0,1,AL QOUZ SECOND,القوز الثانية
1978,5333,0,1,AL QOUZ SECOND,القوز الثانية
1979,5333,0,1,AL QOUZ SECOND,القوز الثانية
1980,5333,0,1,AL QOUZ SECOND,القوز الثانية
1981,5333,0,1,AL QOUZ SECOND,القوز الثانية
1982,5333,0,1,AL QOUZ SECOND,القوز الثانية
1983,5333,0,1,AL QOUZ SECOND,القوز الثانية
1984,5333,0,1,AL QOUZ SECOND,القوز الثانية
1985,5333,0,1,AL QOUZ SECOND,القوز الثانية
1986,5333,0,1,AL QOUZ SECOND,القوز الثانية
1987,5333,1,2,AL QOUZ SECOND,القوز الثانية
1988,5333,0,2,AL QOUZ SECOND,القوز الثانية
1989,5333,2,4,AL QOUZ SECOND,القوز الثانية
1990,5333,0,4,AL QOUZ SECOND,القوز الثانية
1991,5333,1,5,AL QOUZ SECOND,القوز الثانية
1992,5333,1,6,AL QOUZ SECOND,القوز الثانية
1993,5333,0,6,AL QOUZ SECOND,القوز الثانية
1994,5333,1,7,AL QOUZ SECOND,القوز الثانية
1995,5333,0,7,AL QOUZ SECOND,القوز الثانية
1996,5333,0,7,AL QOUZ SECOND,القوز الثانية
1997,5333,1,8,AL QOUZ SECOND,القوز الثانية
1998,5333,1,9,AL QOUZ SECOND,القوز الثانية
1999,5333,1,10,AL QOUZ SECOND,القوز الثانية
2000,5333,0,10,AL QOUZ SECOND,القوز الثانية
2001,5333,2,12,AL QOUZ SECOND,القوز الثانية
2002,5333,0,12,AL QOUZ SECOND,القوز الثانية
2003,5333,2,14,AL QOUZ SECOND,القوز الثانية
2004,5333,3,17,AL QOUZ SECOND,القوز الثانية
2005,5333,2,19,AL QOUZ SECOND,القوز الثانية
2006,5333,0,19,AL QOUZ SECOND,القوز الثانية
2007,5333,1,20,AL QOUZ SECOND,القوز الثانية
2008,5333,4,24,AL QOUZ SECOND,القوز الثانية
2009,5333,1,25,AL QOUZ SECOND,القوز الثانية
2010,5333,4,29,AL QOUZ SECOND,القوز الثانية
2011,5333,3,32,AL QOUZ SECOND,القوز الثانية
2012,5333,4,36,AL QOUZ SECOND,القوز الثانية
2013,5333,3,39,AL QOUZ SECOND,القوز الثانية
2014,5333,1,40,AL QOUZ SECOND,القوز الثانية
2015,5333,5,45,AL QOUZ SECOND,القوز الثانية
2016,5333,3,48,AL QOUZ SECOND,القوز الثانية
2017,5333,3,51,AL QOUZ SECOND,القوز الثانية
2018,5333,6,57,AL QOUZ SECOND,القوز الثانية
2019,5333,16,73,AL QOUZ SECOND,القوز الثانية
2020,5333,31,104,AL QOUZ SECOND,القوز الثانية
2021,5333,0,104,AL QOUZ SECOND,القوز الثانية
1963,5373,2,2,MANKHOOL,منخول
1964,5373,0,2,MANKHOOL,منخول
1965,5373,0,2,MANKHOOL,منخول
1966,5373,0,2,MANKHOOL,منخول
1967,5373,0,2,MANKHOOL,منخول
1968,5373,1,3,MANKHOOL,منخول
1969,5373,1,4,MANKHOOL,منخول
1970,5373,0,4,MANKHOOL,منخول
1971,5373,0,4,MANKHOOL,منخول
1972,5373,0,4,MANKHOOL,منخول
1973,5373,2,6,MANKHOOL,منخول
1974,5373,2,8,MANKHOOL,منخول
1975,5373,1,9,MANKHOOL,منخول
1976,5373,3,12,MANKHOOL,منخول
1977,5373,2,14,MANKHOOL,منخول
1978,5373,2,16,MANKHOOL,منخول
1979,5373,2,18,MANKHOOL,منخول
1980,5373,3,21,MANKHOOL,منخول
1981,5373,4,25,MANKHOOL,منخول
1982,5373,0,25,MANKHOOL,منخول
1983,5373,1,26,MANKHOOL,منخول
1984,5373,2,28,MANKHOOL,منخول
1985,5373,3,31,MANKHOOL,منخول
1986,5373,2,33,MANKHOOL,منخول
1987,5373,3,36,MANKHOOL,منخول
1988,5373,5,41,MANKHOOL,منخول
1989,5373,9,50,MANKHOOL,منخول
1990,5373,8,58,MANKHOOL,منخول
1991,5373,5,63,MANKHOOL,منخول
1992,5373,9,72,MANKHOOL,منخول
1993,5373,4,76,MANKHOOL,منخول
1994,5373,10,86,MANKHOOL,منخول
1995,5373,3,89,MANKHOOL,منخول
1996,5373,11,100,MANKHOOL,منخول
1997,5373,13,113,MANKHOOL,منخول
1998,5373,12,125,MANKHOOL,منخول
1999,5373,14,139,MANKHOOL,منخول
2000,5373,15,154,MANKHOOL,منخول
2001,5373,20,174,MANKHOOL,منخول
2002,5373,17,191,MANKHOOL,منخول
2003,5373,26,217,MANKHOOL,منخول
2004,5373,26,243,MANKHOOL,منخول
2005,5373,33,276,MANKHOOL,منخول
2006,5373,26,302,MANKHOOL,منخول
2007,5373,24,326,MANKHOOL,منخول
2008,5373,41,367,MANKHOOL,منخول
2009,5373,33,400,MANKHOOL,منخول
2010,5373,41,441,MANKHOOL,منخول
2011,5373,44,485,MANKHOOL,منخول
2012,5373,45,530,MANKHOOL,منخول
2013,5373,49,579,MANKHOOL,منخول
2014,5373,53,632,MANKHOOL,منخول
2015,5373,64,696,MANKHOOL,منخول
2016,5373,120,816,MANKHOOL,منخول
2017,5373,78,894,MANKHOOL,منخول
2018,5373,96,990,MANKHOOL,منخول
2019,5373,149,1139,MANKHOOL,منخول
2020,5373,632,1771,MANKHOOL,منخول
2021,5373,0,1771,MANKHOOL,منخول
1963,5453,0,0,AL MANARA,المنارة
1964,5453,0,0,AL MANARA,المنارة
1965,5453,0,0,AL MANARA,المنارة
1966,5453,0,0,AL MANARA,المنارة
1967,5453,0,0,AL MANARA,المنارة
1968,5453,0,0,AL MANARA,المنارة
1969,5453,0,0,AL MANARA,المنارة
1970,5453,0,0,AL MANARA,المنارة
1971,5453,0,0,AL MANARA,المنارة
1972,5453,0,0,AL MANARA,المنارة
1973,5453,0,0,AL MANARA,المنارة
1974,5453,0,0,AL MANARA,المنارة
1975,5453,0,0,AL MANARA,المنارة
1976,5453,0,0,AL MANARA,المنارة
1977,5453,0,0,AL MANARA,المنارة
1978,5453,0,0,AL MANARA,المنارة
1979,5453,0,0,AL MANARA,المنارة
1980,5453,0,0,AL MANARA,المنارة
1981,5453,0,0,AL MANARA,المنارة
1982,5453,2,2,AL MANARA,المنارة
1983,5453,0,2,AL MANARA,المنارة
1984,5453,0,2,AL MANARA,المنارة
1985,5453,1,3,AL MANARA,المنارة
1986,5453,0,3,AL MANARA,المنارة
1987,5453,0,3,AL MANARA,المنارة
1988,5453,1,4,AL MANARA,المنارة
1989,5453,0,4,AL MANARA,المنارة
1990,5453,1,5,AL MANARA,المنارة
1991,5453,0,5,AL MANARA,المنارة
1992,5453,0,5,AL MANARA,المنارة
1993,5453,0,5,AL MANARA,المنارة
1994,5453,1,6,AL MANARA,المنارة
1995,5453,0,6,AL MANARA,المنارة
1996,5453,0,6,AL MANARA,المنارة
1997,5453,1,7,AL MANARA,المنارة
1998,5453,0,7,AL MANARA,المنارة
1999,5453,0,7,AL MANARA,المنارة
2000,5453,1,8,AL MANARA,المنارة
2001,5453,0,8,AL MANARA,المنارة
2002,5453,1,9,AL MANARA,المنارة
2003,5453,0,9,AL MANARA,المنارة
2004,5453,1,10,AL MANARA,المنارة
2005,5453,4,14,AL MANARA,المنارة
2006,5453,3,17,AL MANARA,المنارة
2007,5453,4,21,AL MANARA,المنارة
2008,5453,7,28,AL MANARA,المنارة
2009,5453,7,35,AL MANARA,المنارة
2010,5453,3,38,AL MANARA,المنارة
2011,5453,6,44,AL MANARA,المنارة
2012,5453,7,51,AL MANARA,المنارة
2013,5453,8,59,AL MANARA,المنارة
2014,5453,16,75,AL MANARA,المنارة
2015,5453,6,81,AL MANARA,المنارة
2016,5453,7,88,AL MANARA,المنارة
2017,5453,10,98,AL MANARA,المنارة
2018,5453,5,103,AL MANARA,المنارة
2019,5453,15,118,AL MANARA,المنارة
2020,5453,37,155,AL MANARA,المنارة
2021,5453,0,155,AL MANARA,المنارة
1963,5493,0,0,WADI AL SAFA 4,وادي الصفا 4
1964,5493,0,0,WADI AL SAFA 4,وادي الصفا 4
1965,5493,0,0,WADI AL SAFA 4,وادي الصفا 4
1966,5493,0,0,WADI AL SAFA 4,وادي الصفا 4
1967,5493,0,0,WADI AL SAFA 4,وادي الصفا 4
1968,5493,0,0,WADI AL SAFA 4,وادي الصفا 4
1969,5493,0,0,WADI AL SAFA 4,وادي الصفا 4
1970,5493,0,0,WADI AL SAFA 4,وادي الصفا 4
1971,5493,0,0,WADI AL SAFA 4,وادي الصفا 4
1972,5493,0,0,WADI AL SAFA 4,وادي الصفا 4
1973,5493,0,0,WADI AL SAFA 4,وادي الصفا 4
1974,5493,0,0,WADI AL SAFA 4,وادي الصفا 4
1975,5493,0,0,WADI AL SAFA 4,وادي الصفا 4
1976,5493,0,0,WADI AL SAFA 4,وادي الصفا 4
1977,5493,0,0,WADI AL SAFA 4,وادي الصفا 4
1978,5493,0,0,WADI AL SAFA 4,وادي الصفا 4
1979,5493,0,0,WADI AL SAFA 4,وادي الصفا 4
1980,5493,0,0,WADI AL SAFA 4,وادي الصفا 4
1981,5493,0,0,WADI AL SAFA 4,وادي الصفا 4
1982,5493,0,0,WADI AL SAFA 4,وادي الصفا 4
1983,5493,0,0,WADI AL SAFA 4,وادي الصفا 4
1984,5493,0,0,WADI AL SAFA 4,وادي الصفا 4
1985,5493,0,0,WADI AL SAFA 4,وادي الصفا 4
1986,5493,0,0,WADI AL SAFA 4,وادي الصفا 4
1987,5493,0,0,WADI AL SAFA 4,وادي الصفا 4
1988,5493,0,0,WADI AL SAFA 4,وادي الصفا 4
1989,5493,0,0,WADI AL SAFA 4,وادي الصفا 4
1990,5493,0,0,WADI AL SAFA 4,وادي الصفا 4
1991,5493,0,0,WADI AL SAFA 4,وادي الصفا 4
1992,5493,0,0,WADI AL SAFA 4,وادي الصفا 4
1993,5493,0,0,WADI AL SAFA 4,وادي الصفا 4
1994,5493,0,0,WADI AL SAFA 4,وادي الصفا 4
1995,5493,0,0,WADI AL SAFA 4,وادي الصفا 4
1996,5493,0,0,WADI AL SAFA 4,وادي الصفا 4
1997,5493,0,0,WADI AL SAFA 4,وادي الصفا 4
1998,5493,0,0,WADI AL SAFA 4,وادي الصفا 4
1999,5493,0,0,WADI AL SAFA 4,وادي الصفا 4
2000,5493,0,0,WADI AL SAFA 4,وادي الصفا 4
2001,5493,0,0,WADI AL SAFA 4,وادي الصفا 4
2002,5493,0,0,WADI AL SAFA 4,وادي الصفا 4
2003,5493,0,0,WADI AL SAFA 4,وادي الصفا 4
2004,5493,0,0,WADI AL SAFA 4,وادي الصفا 4
2005,5493,0,0,WADI AL SAFA 4,وادي الصفا 4
2006,5493,0,0,WADI AL SAFA 4,وادي الصفا 4
2007,5493,0,0,WADI AL SAFA 4,وادي الصفا 4
2008,5493,0,0,WADI AL SAFA 4,وادي الصفا 4
2009,5493,1,1,WADI AL SAFA 4,وادي الصفا 4
2010,5493,1,2,WADI AL SAFA 4,وادي الصفا 4
2011,5493,1,3,WADI AL SAFA 4,وادي الصفا 4
2012,5493,0,3,WADI AL SAFA 4,وادي الصفا 4
2013,5493,0,3,WADI AL SAFA 4,وادي الصفا 4
2014,5493,2,5,WADI AL SAFA 4,وادي الصفا 4
2015,5493,0,5,WADI AL SAFA 4,وادي الصفا 4
2016,5493,1,6,WADI AL SAFA 4,وادي الصفا 4
2017,5493,0,6,WADI AL SAFA 4,وادي الصفا 4
2018,5493,0,6,WADI AL SAFA 4,وادي الصفا 4
2019,5493,9,15,WADI AL SAFA 4,وادي الصفا 4
2020,5493,6,21,WADI AL SAFA 4,وادي الصفا 4
2021,5493,0,21,WADI AL SAFA 4,وادي الصفا 4
1963,5533,40,40,AL SOUQ AL KABEER,السوق الكبير
1964,5533,5,45,AL SOUQ AL KABEER,السوق الكبير
1965,5533,4,49,AL SOUQ AL KABEER,السوق الكبير
1966,5533,5,54,AL SOUQ AL KABEER,السوق الكبير
1967,5533,3,57,AL SOUQ AL KABEER,السوق الكبير
1968,5533,5,62,AL SOUQ AL KABEER,السوق الكبير
1969,5533,2,64,AL SOUQ AL KABEER,السوق الكبير
1970,5533,5,69,AL SOUQ AL KABEER,السوق الكبير
1971,5533,12,81,AL SOUQ AL KABEER,السوق الكبير
1972,5533,8,89,AL SOUQ AL KABEER,السوق الكبير
1973,5533,5,94,AL SOUQ AL KABEER,السوق الكبير
1974,5533,7,101,AL SOUQ AL KABEER,السوق الكبير
1975,5533,18,119,AL SOUQ AL KABEER,السوق الكبير
1976,5533,19,138,AL SOUQ AL KABEER,السوق الكبير
1977,5533,16,154,AL SOUQ AL KABEER,السوق الكبير
1978,5533,24,178,AL SOUQ AL KABEER,السوق الكبير
1979,5533,27,205,AL SOUQ AL KABEER,السوق الكبير
1980,5533,38,243,AL SOUQ AL KABEER,السوق الكبير
1981,5533,44,287,AL SOUQ AL KABEER,السوق الكبير
1982,5533,27,314,AL SOUQ AL KABEER,السوق الكبير
1983,5533,40,354,AL SOUQ AL KABEER,السوق الكبير
1984,5533,25,379,AL SOUQ AL KABEER,السوق الكبير
1985,5533,26,405,AL SOUQ AL KABEER,السوق الكبير
1986,5533,34,439,AL SOUQ AL KABEER,السوق الكبير
1987,5533,37,476,AL SOUQ AL KABEER,السوق الكبير
1988,5533,50,526,AL SOUQ AL KABEER,السوق الكبير
1989,5533,51,577,AL SOUQ AL KABEER,السوق الكبير
1990,5533,56,633,AL SOUQ AL KABEER,السوق الكبير
1991,5533,48,681,AL SOUQ AL KABEER,السوق الكبير
1992,5533,50,731,AL SOUQ AL KABEER,السوق الكبير
1993,5533,72,803,AL SOUQ AL KABEER,السوق الكبير
1994,5533,61,864,AL SOUQ AL KABEER,السوق الكبير
1995,5533,44,908,AL SOUQ AL KABEER,السوق الكبير
1996,5533,68,976,AL SOUQ AL KABEER,السوق الكبير
1997,5533,68,1044,AL SOUQ AL KABEER,السوق الكبير
1998,5533,74,1118,AL SOUQ AL KABEER,السوق الكبير
1999,5533,67,1185,AL SOUQ AL KABEER,السوق الكبير
2000,5533,102,1287,AL SOUQ AL KABEER,السوق الكبير
2001,5533,92,1379,AL SOUQ AL KABEER,السوق الكبير
2002,5533,117,1496,AL SOUQ AL KABEER,السوق الكبير
2003,5533,129,1625,AL SOUQ AL KABEER,السوق الكبير
2004,5533,137,1762,AL SOUQ AL KABEER,السوق الكبير
2005,5533,138,1900,AL SOUQ AL KABEER,السوق الكبير
2006,5533,125,2025,AL SOUQ AL KABEER,السوق الكبير
2007,5533,149,2174,AL SOUQ AL KABEER,السوق الكبير
2008,5533,125,2299,AL SOUQ AL KABEER,السوق الكبير
2009,5533,119,2418,AL SOUQ AL KABEER,السوق الكبير
2010,5533,136,2554,AL SOUQ AL KABEER,السوق الكبير
2011,5533,107,2661,AL SOUQ AL KABEER,السوق الكبير
2012,5533,104,2765,AL SOUQ AL KABEER,السوق الكبير
2013,5533,128,2893,AL SOUQ AL KABEER,السوق الكبير
2014,5533,133,3026,AL SOUQ AL KABEER,السوق الكبير
2015,5533,126,3152,AL SOUQ AL KABEER,السوق الكبير
2016,5533,129,3281,AL SOUQ AL KABEER,السوق الكبير
2017,5533,146,3427,AL SOUQ AL KABEER,السوق الكبير
2018,5533,142,3569,AL SOUQ AL KABEER,السوق الكبير
2019,5533,442,4011,AL SOUQ AL KABEER,السوق الكبير
2020,5533,1551,5562,AL SOUQ AL KABEER,السوق الكبير
2021,5533,0,5562,AL SOUQ AL KABEER,السوق الكبير
1963,5653,0,0,"AL WARQA'A THIRD",الورقاء الثالثة
1964,5653,0,0,"AL WARQA'A THIRD",الورقاء الثالثة
1965,5653,0,0,"AL WARQA'A THIRD",الورقاء الثالثة
1966,5653,0,0,"AL WARQA'A THIRD",الورقاء الثالثة
1967,5653,0,0,"AL WARQA'A THIRD",الورقاء الثالثة
1968,5653,0,0,"AL WARQA'A THIRD",الورقاء الثالثة
1969,5653,0,0,"AL WARQA'A THIRD",الورقاء الثالثة
1970,5653,0,0,"AL WARQA'A THIRD",الورقاء الثالثة
1971,5653,0,0,"AL WARQA'A THIRD",الورقاء الثالثة
1972,5653,0,0,"AL WARQA'A THIRD",الورقاء الثالثة
1973,5653,0,0,"AL WARQA'A THIRD",الورقاء الثالثة
1974,5653,0,0,"AL WARQA'A THIRD",الورقاء الثالثة
1975,5653,0,0,"AL WARQA'A THIRD",الورقاء الثالثة
1976,5653,0,0,"AL WARQA'A THIRD",الورقاء الثالثة
1977,5653,0,0,"AL WARQA'A THIRD",الورقاء الثالثة
1978,5653,1,1,"AL WARQA'A THIRD",الورقاء الثالثة
1979,5653,0,1,"AL WARQA'A THIRD",الورقاء الثالثة
1980,5653,0,1,"AL WARQA'A THIRD",الورقاء الثالثة
1981,5653,0,1,"AL WARQA'A THIRD",الورقاء الثالثة
1982,5653,0,1,"AL WARQA'A THIRD",الورقاء الثالثة
1983,5653,0,1,"AL WARQA'A THIRD",الورقاء الثالثة
1984,5653,0,1,"AL WARQA'A THIRD",الورقاء الثالثة
1985,5653,0,1,"AL WARQA'A THIRD",الورقاء الثالثة
1986,5653,0,1,"AL WARQA'A THIRD",الورقاء الثالثة
1987,5653,0,1,"AL WARQA'A THIRD",الورقاء الثالثة
1988,5653,0,1,"AL WARQA'A THIRD",الورقاء الثالثة
1989,5653,0,1,"AL WARQA'A THIRD",الورقاء الثالثة
1990,5653,0,1,"AL WARQA'A THIRD",الورقاء الثالثة
1991,5653,0,1,"AL WARQA'A THIRD",الورقاء الثالثة
1992,5653,0,1,"AL WARQA'A THIRD",الورقاء الثالثة
1993,5653,0,1,"AL WARQA'A THIRD",الورقاء الثالثة
1994,5653,0,1,"AL WARQA'A THIRD",الورقاء الثالثة
1995,5653,0,1,"AL WARQA'A THIRD",الورقاء الثالثة
1996,5653,0,1,"AL WARQA'A THIRD",الورقاء الثالثة
1997,5653,0,1,"AL WARQA'A THIRD",الورقاء الثالثة
1998,5653,0,1,"AL WARQA'A THIRD",الورقاء الثالثة
1999,5653,0,1,"AL WARQA'A THIRD",الورقاء الثالثة
2000,5653,0,1,"AL WARQA'A THIRD",الورقاء الثالثة
2001,5653,0,1,"AL WARQA'A THIRD",الورقاء الثالثة
2002,5653,0,1,"AL WARQA'A THIRD",الورقاء الثالثة
2003,5653,0,1,"AL WARQA'A THIRD",الورقاء الثالثة
2004,5653,2,3,"AL WARQA'A THIRD",الورقاء الثالثة
2005,5653,0,3,"AL WARQA'A THIRD",الورقاء الثالثة
2006,5653,1,4,"AL WARQA'A THIRD",الورقاء الثالثة
2007,5653,1,5,"AL WARQA'A THIRD",الورقاء الثالثة
2008,5653,0,5,"AL WARQA'A THIRD",الورقاء الثالثة
2009,5653,0,5,"AL WARQA'A THIRD",الورقاء الثالثة
2010,5653,0,5,"AL WARQA'A THIRD",الورقاء الثالثة
2011,5653,2,7,"AL WARQA'A THIRD",الورقاء الثالثة
2012,5653,2,9,"AL WARQA'A THIRD",الورقاء الثالثة
2013,5653,2,11,"AL WARQA'A THIRD",الورقاء الثالثة
2014,5653,1,12,"AL WARQA'A THIRD",الورقاء الثالثة
2015,5653,3,15,"AL WARQA'A THIRD",الورقاء الثالثة
2016,5653,3,18,"AL WARQA'A THIRD",الورقاء الثالثة
2017,5653,5,23,"AL WARQA'A THIRD",الورقاء الثالثة
2018,5653,9,32,"AL WARQA'A THIRD",الورقاء الثالثة
2019,5653,17,49,"AL WARQA'A THIRD",الورقاء الثالثة
2020,5653,97,146,"AL WARQA'A THIRD",الورقاء الثالثة
2021,5653,0,146,"AL WARQA'A THIRD",الورقاء الثالثة
1963,5693,0,0,AL MIZHAR SECOND,المزهر الثانية
1964,5693,0,0,AL MIZHAR SECOND,المزهر الثانية
1965,5693,0,0,AL MIZHAR SECOND,المزهر الثانية
1966,5693,0,0,AL MIZHAR SECOND,المزهر الثانية
1967,5693,0,0,AL MIZHAR SECOND,المزهر الثانية
1968,5693,0,0,AL MIZHAR SECOND,المزهر الثانية
1969,5693,0,0,AL MIZHAR SECOND,المزهر الثانية
1970,5693,0,0,AL MIZHAR SECOND,المزهر الثانية
1971,5693,0,0,AL MIZHAR SECOND,المزهر الثانية
1972,5693,0,0,AL MIZHAR SECOND,المزهر الثانية
1973,5693,0,0,AL MIZHAR SECOND,المزهر الثانية
1974,5693,0,0,AL MIZHAR SECOND,المزهر الثانية
1975,5693,0,0,AL MIZHAR SECOND,المزهر الثانية
1976,5693,0,0,AL MIZHAR SECOND,المزهر الثانية
1977,5693,0,0,AL MIZHAR SECOND,المزهر الثانية
1978,5693,0,0,AL MIZHAR SECOND,المزهر الثانية
1979,5693,0,0,AL MIZHAR SECOND,المزهر الثانية
1980,5693,0,0,AL MIZHAR SECOND,المزهر الثانية
1981,5693,0,0,AL MIZHAR SECOND,المزهر الثانية
1982,5693,0,0,AL MIZHAR SECOND,المزهر الثانية
1983,5693,0,0,AL MIZHAR SECOND,المزهر الثانية
1984,5693,0,0,AL MIZHAR SECOND,المزهر الثانية
1985,5693,0,0,AL MIZHAR SECOND,المزهر الثانية
1986,5693,0,0,AL MIZHAR SECOND,المزهر الثانية
1987,5693,0,0,AL MIZHAR SECOND,المزهر الثانية
1988,5693,0,0,AL MIZHAR SECOND,المزهر الثانية
1989,5693,0,0,AL MIZHAR SECOND,المزهر الثانية
1990,5693,0,0,AL MIZHAR SECOND,المزهر الثانية
1991,5693,0,0,AL MIZHAR SECOND,المزهر الثانية
1992,5693,0,0,AL MIZHAR SECOND,المزهر الثانية
1993,5693,0,0,AL MIZHAR SECOND,المزهر الثانية
1994,5693,1,1,AL MIZHAR SECOND,المزهر الثانية
1995,5693,0,1,AL MIZHAR SECOND,المزهر الثانية
1996,5693,0,1,AL MIZHAR SECOND,المزهر الثانية
1997,5693,0,1,AL MIZHAR SECOND,المزهر الثانية
1998,5693,0,1,AL MIZHAR SECOND,المزهر الثانية
1999,5693,0,1,AL MIZHAR SECOND,المزهر الثانية
2000,5693,0,1,AL MIZHAR SECOND,المزهر الثانية
2001,5693,1,2,AL MIZHAR SECOND,المزهر الثانية
2002,5693,0,2,AL MIZHAR SECOND,المزهر الثانية
2003,5693,1,3,AL MIZHAR SECOND,المزهر الثانية
2004,5693,1,4,AL MIZHAR SECOND,المزهر الثانية
2005,5693,0,4,AL MIZHAR SECOND,المزهر الثانية
2006,5693,0,4,AL MIZHAR SECOND,المزهر الثانية
2007,5693,0,4,AL MIZHAR SECOND,المزهر الثانية
2008,5693,0,4,AL MIZHAR SECOND,المزهر الثانية
2009,5693,1,5,AL MIZHAR SECOND,المزهر الثانية
2010,5693,0,5,AL MIZHAR SECOND,المزهر الثانية
2011,5693,2,7,AL MIZHAR SECOND,المزهر الثانية
2012,5693,0,7,AL MIZHAR SECOND,المزهر الثانية
2013,5693,1,8,AL MIZHAR SECOND,المزهر الثانية
2014,5693,2,10,AL MIZHAR SECOND,المزهر الثانية
2015,5693,2,12,AL MIZHAR SECOND,المزهر الثانية
2016,5693,1,13,AL MIZHAR SECOND,المزهر الثانية
2017,5693,5,18,AL MIZHAR SECOND,المزهر الثانية
2018,5693,6,24,AL MIZHAR SECOND,المزهر الثانية
2019,5693,12,36,AL MIZHAR SECOND,المزهر الثانية
2020,5693,73,109,AL MIZHAR SECOND,المزهر الثانية
2021,5693,0,109,AL MIZHAR SECOND,المزهر الثانية
1963,5733,0,0,HADAEQ SHEIKH MOHAMMED BIN RASHID,حدائق الشيخ محمد بن راشد
1964,5733,0,0,HADAEQ SHEIKH MOHAMMED BIN RASHID,حدائق الشيخ محمد بن راشد
1965,5733,0,0,HADAEQ SHEIKH MOHAMMED BIN RASHID,حدائق الشيخ محمد بن راشد
1966,5733,0,0,HADAEQ SHEIKH MOHAMMED BIN RASHID,حدائق الشيخ محمد بن راشد
1967,5733,0,0,HADAEQ SHEIKH MOHAMMED BIN RASHID,حدائق الشيخ محمد بن راشد
1968,5733,0,0,HADAEQ SHEIKH MOHAMMED BIN RASHID,حدائق الشيخ محمد بن راشد
1969,5733,0,0,HADAEQ SHEIKH MOHAMMED BIN RASHID,حدائق الشيخ محمد بن راشد
1970,5733,0,0,HADAEQ SHEIKH MOHAMMED BIN RASHID,حدائق الشيخ محمد بن راشد
1971,5733,0,0,HADAEQ SHEIKH MOHAMMED BIN RASHID,حدائق الشيخ محمد بن راشد
1972,5733,0,0,HADAEQ SHEIKH MOHAMMED BIN RASHID,حدائق الشيخ محمد بن راشد
1973,5733,0,0,HADAEQ SHEIKH MOHAMMED BIN RASHID,حدائق الشيخ محمد بن راشد
1974,5733,0,0,HADAEQ SHEIKH MOHAMMED BIN RASHID,حدائق الشيخ محمد بن راشد
1975,5733,0,0,HADAEQ SHEIKH MOHAMMED BIN RASHID,حدائق الشيخ محمد بن راشد
1976,5733,0,0,HADAEQ SHEIKH MOHAMMED BIN RASHID,حدائق الشيخ محمد بن راشد
1977,5733,0,0,HADAEQ SHEIKH MOHAMMED BIN RASHID,حدائق الشيخ محمد بن راشد
1978,5733,0,0,HADAEQ SHEIKH MOHAMMED BIN RASHID,حدائق الشيخ محمد بن راشد
1979,5733,0,0,HADAEQ SHEIKH MOHAMMED BIN RASHID,حدائق الشيخ محمد بن راشد
1980,5733,0,0,HADAEQ SHEIKH MOHAMMED BIN RASHID,حدائق الشيخ محمد بن راشد
1981,5733,0,0,HADAEQ SHEIKH MOHAMMED BIN RASHID,حدائق الشيخ محمد بن راشد
1982,5733,0,0,HADAEQ SHEIKH MOHAMMED BIN RASHID,حدائق الشيخ محمد بن راشد
1983,5733,0,0,HADAEQ SHEIKH MOHAMMED BIN RASHID,حدائق الشيخ محمد بن راشد
1984,5733,0,0,HADAEQ SHEIKH MOHAMMED BIN RASHID,حدائق الشيخ محمد بن راشد
1985,5733,0,0,HADAEQ SHEIKH MOHAMMED BIN RASHID,حدائق الشيخ محمد بن راشد
1986,5733,0,0,HADAEQ SHEIKH MOHAMMED BIN RASHID,حدائق الشيخ محمد بن راشد
1987,5733,0,0,HADAEQ SHEIKH MOHAMMED BIN RASHID,حدائق الشيخ محمد بن راشد
1988,5733,0,0,HADAEQ SHEIKH MOHAMMED BIN RASHID,حدائق الشيخ محمد بن راشد
1989,5733,0,0,HADAEQ SHEIKH MOHAMMED BIN RASHID,حدائق الشيخ محمد بن راشد
1990,5733,0,0,HADAEQ SHEIKH MOHAMMED BIN RASHID,حدائق الشيخ محمد بن راشد
1991,5733,0,0,HADAEQ SHEIKH MOHAMMED BIN RASHID,حدائق الشيخ محمد بن راشد
1992,5733,0,0,HADAEQ SHEIKH MOHAMMED BIN RASHID,حدائق الشيخ محمد بن راشد
1993,5733,0,0,HADAEQ SHEIKH MOHAMMED BIN RASHID,حدائق الشيخ محمد بن راشد
1994,5733,0,0,HADAEQ SHEIKH MOHAMMED BIN RASHID,حدائق الشيخ محمد بن راشد
1995,5733,0,0,HADAEQ SHEIKH MOHAMMED BIN RASHID,حدائق الشيخ محمد بن راشد
1996,5733,0,0,HADAEQ SHEIKH MOHAMMED BIN RASHID,حدائق الشيخ محمد بن راشد
1997,5733,0,0,HADAEQ SHEIKH MOHAMMED BIN RASHID,حدائق الشيخ محمد بن راشد
1998,5733,0,0,HADAEQ SHEIKH MOHAMMED BIN RASHID,حدائق الشيخ محمد بن راشد
1999,5733,0,0,HADAEQ SHEIKH MOHAMMED BIN RASHID,حدائق الشيخ محمد بن راشد
2000,5733,0,0,HADAEQ SHEIKH MOHAMMED BIN RASHID,حدائق الشيخ محمد بن راشد
2001,5733,0,0,HADAEQ SHEIKH MOHAMMED BIN RASHID,حدائق الشيخ محمد بن راشد
2002,5733,0,0,HADAEQ SHEIKH MOHAMMED BIN RASHID,حدائق الشيخ محمد بن راشد
2003,5733,0,0,HADAEQ SHEIKH MOHAMMED BIN RASHID,حدائق الشيخ محمد بن راشد
2004,5733,0,0,HADAEQ SHEIKH MOHAMMED BIN RASHID,حدائق الشيخ محمد بن راشد
2005,5733,0,0,HADAEQ SHEIKH MOHAMMED BIN RASHID,حدائق الشيخ محمد بن راشد
2006,5733,0,0,HADAEQ SHEIKH MOHAMMED BIN RASHID,حدائق الشيخ محمد بن راشد
2007,5733,2,2,HADAEQ SHEIKH MOHAMMED BIN RASHID,حدائق الشيخ محمد بن راشد
2008,5733,0,2,HADAEQ SHEIKH MOHAMMED BIN RASHID,حدائق الشيخ محمد بن راشد
2009,5733,1,3,HADAEQ SHEIKH MOHAMMED BIN RASHID,حدائق الشيخ محمد بن راشد
2010,5733,0,3,HADAEQ SHEIKH MOHAMMED BIN RASHID,حدائق الشيخ محمد بن راشد
2011,5733,0,3,HADAEQ SHEIKH MOHAMMED BIN RASHID,حدائق الشيخ محمد بن راشد
2012,5733,0,3,HADAEQ SHEIKH MOHAMMED BIN RASHID,حدائق الشيخ محمد بن راشد
2013,5733,1,4,HADAEQ SHEIKH MOHAMMED BIN RASHID,حدائق الشيخ محمد بن راشد
2014,5733,0,4,HADAEQ SHEIKH MOHAMMED BIN RASHID,حدائق الشيخ محمد بن راشد
2015,5733,1,5,HADAEQ SHEIKH MOHAMMED BIN RASHID,حدائق الشيخ محمد بن راشد
2016,5733,0,5,HADAEQ SHEIKH MOHAMMED BIN RASHID,حدائق الشيخ محمد بن راشد
2017,5733,1,6,HADAEQ SHEIKH MOHAMMED BIN RASHID,حدائق الشيخ محمد بن راشد
2018,5733,1,7,HADAEQ SHEIKH MOHAMMED BIN RASHID,حدائق الشيخ محمد بن راشد
2019,5733,2,9,HADAEQ SHEIKH MOHAMMED BIN RASHID,حدائق الشيخ محمد بن راشد
2020,5733,0,9,HADAEQ SHEIKH MOHAMMED BIN RASHID,حدائق الشيخ محمد بن راشد
2021,5733,0,9,HADAEQ SHEIKH MOHAMMED BIN RASHID,حدائق الشيخ محمد بن راشد
1963,5773,0,0,NADD AL SHIBA FOURTH,ند الشبا الرابعة
1964,5773,0,0,NADD AL SHIBA FOURTH,ند الشبا الرابعة
1965,5773,0,0,NADD AL SHIBA FOURTH,ند الشبا الرابعة
1966,5773,0,0,NADD AL SHIBA FOURTH,ند الشبا الرابعة
1967,5773,0,0,NADD AL SHIBA FOURTH,ند الشبا الرابعة
1968,5773,0,0,NADD AL SHIBA FOURTH,ند الشبا الرابعة
1969,5773,1,1,NADD AL SHIBA FOURTH,ند الشبا الرابعة
1970,5773,0,1,NADD AL SHIBA FOURTH,ند الشبا الرابعة
1971,5773,0,1,NADD AL SHIBA FOURTH,ند الشبا الرابعة
1972,5773,0,1,NADD AL SHIBA FOURTH,ند الشبا الرابعة
1973,5773,0,1,NADD AL SHIBA FOURTH,ند الشبا الرابعة
1974,5773,0,1,NADD AL SHIBA FOURTH,ند الشبا الرابعة
1975,5773,0,1,NADD AL SHIBA FOURTH,ند الشبا الرابعة
1976,5773,0,1,NADD AL SHIBA FOURTH,ند الشبا الرابعة
1977,5773,0,1,NADD AL SHIBA FOURTH,ند الشبا الرابعة
1978,5773,0,1,NADD AL SHIBA FOURTH,ند الشبا الرابعة
1979,5773,0,1,NADD AL SHIBA FOURTH,ند الشبا الرابعة
1980,5773,0,1,NADD AL SHIBA FOURTH,ند الشبا الرابعة
1981,5773,0,1,NADD AL SHIBA FOURTH,ند الشبا الرابعة
1982,5773,0,1,NADD AL SHIBA FOURTH,ند الشبا الرابعة
1983,5773,0,1,NADD AL SHIBA FOURTH,ند الشبا الرابعة
1984,5773,0,1,NADD AL SHIBA FOURTH,ند الشبا الرابعة
1985,5773,0,1,NADD AL SHIBA FOURTH,ند الشبا الرابعة
1986,5773,0,1,NADD AL SHIBA FOURTH,ند الشبا الرابعة
1987,5773,0,1,NADD AL SHIBA FOURTH,ند الشبا الرابعة
1988,5773,0,1,NADD AL SHIBA FOURTH,ند الشبا الرابعة
1989,5773,0,1,NADD AL SHIBA FOURTH,ند الشبا الرابعة
1990,5773,0,1,NADD AL SHIBA FOURTH,ند الشبا الرابعة
1991,5773,0,1,NADD AL SHIBA FOURTH,ند الشبا الرابعة
1992,5773,0,1,NADD AL SHIBA FOURTH,ند الشبا الرابعة
1993,5773,0,1,NADD AL SHIBA FOURTH,ند الشبا الرابعة
1994,5773,0,1,NADD AL SHIBA FOURTH,ند الشبا الرابعة
1995,5773,0,1,NADD AL SHIBA FOURTH,ند الشبا الرابعة
1996,5773,0,1,NADD AL SHIBA FOURTH,ند الشبا الرابعة
1997,5773,1,2,NADD AL SHIBA FOURTH,ند الشبا الرابعة
1998,5773,0,2,NADD AL SHIBA FOURTH,ند الشبا الرابعة
1999,5773,0,2,NADD AL SHIBA FOURTH,ند الشبا الرابعة
2000,5773,0,2,NADD AL SHIBA FOURTH,ند الشبا الرابعة
2001,5773,1,3,NADD AL SHIBA FOURTH,ند الشبا الرابعة
2002,5773,2,5,NADD AL SHIBA FOURTH,ند الشبا الرابعة
2003,5773,0,5,NADD AL SHIBA FOURTH,ند الشبا الرابعة
2004,5773,0,5,NADD AL SHIBA FOURTH,ند الشبا الرابعة
2005,5773,2,7,NADD AL SHIBA FOURTH,ند الشبا الرابعة
2006,5773,8,15,NADD AL SHIBA FOURTH,ند الشبا الرابعة
2007,5773,1,16,NADD AL SHIBA FOURTH,ند الشبا الرابعة
2008,5773,1,17,NADD AL SHIBA FOURTH,ند الشبا الرابعة
2009,5773,0,17,NADD AL SHIBA FOURTH,ند الشبا الرابعة
2010,5773,3,20,NADD AL SHIBA FOURTH,ند الشبا الرابعة
2011,5773,3,23,NADD AL SHIBA FOURTH,ند الشبا الرابعة
2012,5773,1,24,NADD AL SHIBA FOURTH,ند الشبا الرابعة
2013,5773,3,27,NADD AL SHIBA FOURTH,ند الشبا الرابعة
2014,5773,9,36,NADD AL SHIBA FOURTH,ند الشبا الرابعة
2015,5773,7,43,NADD AL SHIBA FOURTH,ند الشبا الرابعة
2016,5773,3,46,NADD AL SHIBA FOURTH,ند الشبا الرابعة
2017,5773,6,52,NADD AL SHIBA FOURTH,ند الشبا الرابعة
2018,5773,20,72,NADD AL SHIBA FOURTH,ند الشبا الرابعة
2019,5773,22,94,NADD AL SHIBA FOURTH,ند الشبا الرابعة
2020,5773,52,146,NADD AL SHIBA FOURTH,ند الشبا الرابعة
2021,5773,0,146,NADD AL SHIBA FOURTH,ند الشبا الرابعة
1963,5813,0,0,AL QOUZ FOURTH,القوز الرابعة
1964,5813,0,0,AL QOUZ FOURTH,القوز الرابعة
1965,5813,0,0,AL QOUZ FOURTH,القوز الرابعة
1966,5813,0,0,AL QOUZ FOURTH,القوز الرابعة
1967,5813,0,0,AL QOUZ FOURTH,القوز الرابعة
1968,5813,0,0,AL QOUZ FOURTH,القوز الرابعة
1969,5813,0,0,AL QOUZ FOURTH,القوز الرابعة
1970,5813,0,0,AL QOUZ FOURTH,القوز الرابعة
1971,5813,0,0,AL QOUZ FOURTH,القوز الرابعة
1972,5813,0,0,AL QOUZ FOURTH,القوز الرابعة
1973,5813,0,0,AL QOUZ FOURTH,القوز الرابعة
1974,5813,0,0,AL QOUZ FOURTH,القوز الرابعة
1975,5813,1,1,AL QOUZ FOURTH,القوز الرابعة
1976,5813,0,1,AL QOUZ FOURTH,القوز الرابعة
1977,5813,0,1,AL QOUZ FOURTH,القوز الرابعة
1978,5813,0,1,AL QOUZ FOURTH,القوز الرابعة
1979,5813,0,1,AL QOUZ FOURTH,القوز الرابعة
1980,5813,0,1,AL QOUZ FOURTH,القوز الرابعة
1981,5813,0,1,AL QOUZ FOURTH,القوز الرابعة
1982,5813,0,1,AL QOUZ FOURTH,القوز الرابعة
1983,5813,0,1,AL QOUZ FOURTH,القوز الرابعة
1984,5813,0,1,AL QOUZ FOURTH,القوز الرابعة
1985,5813,0,1,AL QOUZ FOURTH,القوز الرابعة
1986,5813,0,1,AL QOUZ FOURTH,القوز الرابعة
1987,5813,0,1,AL QOUZ FOURTH,القوز الرابعة
1988,5813,0,1,AL QOUZ FOURTH,القوز الرابعة
1989,5813,0,1,AL QOUZ FOURTH,القوز الرابعة
1990,5813,0,1,AL QOUZ FOURTH,القوز الرابعة
1991,5813,0,1,AL QOUZ FOURTH,القوز الرابعة
1992,5813,1,2,AL QOUZ FOURTH,القوز الرابعة
1993,5813,1,3,AL QOUZ FOURTH,القوز الرابعة
1994,5813,0,3,AL QOUZ FOURTH,القوز الرابعة
1995,5813,0,3,AL QOUZ FOURTH,القوز الرابعة
1996,5813,2,5,AL QOUZ FOURTH,القوز الرابعة
1997,5813,0,5,AL QOUZ FOURTH,القوز الرابعة
1998,5813,1,6,AL QOUZ FOURTH,القوز الرابعة
1999,5813,2,8,AL QOUZ FOURTH,القوز الرابعة
2000,5813,1,9,AL QOUZ FOURTH,القوز الرابعة
2001,5813,2,11,AL QOUZ FOURTH,القوز الرابعة
2002,5813,3,14,AL QOUZ FOURTH,القوز الرابعة
2003,5813,2,16,AL QOUZ FOURTH,القوز الرابعة
2004,5813,1,17,AL QOUZ FOURTH,القوز الرابعة
2005,5813,4,21,AL QOUZ FOURTH,القوز الرابعة
2006,5813,2,23,AL QOUZ FOURTH,القوز الرابعة
2007,5813,2,25,AL QOUZ FOURTH,القوز الرابعة
2008,5813,1,26,AL QOUZ FOURTH,القوز الرابعة
2009,5813,2,28,AL QOUZ FOURTH,القوز الرابعة
2010,5813,8,36,AL QOUZ FOURTH,القوز الرابعة
2011,5813,6,42,AL QOUZ FOURTH,القوز الرابعة
2012,5813,8,50,AL QOUZ FOURTH,القوز الرابعة
2013,5813,4,54,AL QOUZ FOURTH,القوز الرابعة
2014,5813,5,59,AL QOUZ FOURTH,القوز الرابعة
2015,5813,10,69,AL QOUZ FOURTH,القوز الرابعة
2016,5813,7,76,AL QOUZ FOURTH,القوز الرابعة
2017,5813,6,82,AL QOUZ FOURTH,القوز الرابعة
2018,5813,10,92,AL QOUZ FOURTH,القوز الرابعة
2019,5813,9,101,AL QOUZ FOURTH,القوز الرابعة
2020,5813,35,136,AL QOUZ FOURTH,القوز الرابعة
2021,5813,0,136,AL QOUZ FOURTH,القوز الرابعة
1963,5853,0,0,AL MARMOOM,المرموم
1964,5853,0,0,AL MARMOOM,المرموم
1965,5853,0,0,AL MARMOOM,المرموم
1966,5853,0,0,AL MARMOOM,المرموم
1967,5853,0,0,AL MARMOOM,المرموم
1968,5853,0,0,AL MARMOOM,المرموم
1969,5853,0,0,AL MARMOOM,المرموم
1970,5853,0,0,AL MARMOOM,المرموم
1971,5853,0,0,AL MARMOOM,المرموم
1972,5853,0,0,AL MARMOOM,المرموم
1973,5853,0,0,AL MARMOOM,المرموم
1974,5853,0,0,AL MARMOOM,المرموم
1975,5853,0,0,AL MARMOOM,المرموم
1976,5853,0,0,AL MARMOOM,المرموم
1977,5853,0,0,AL MARMOOM,المرموم
1978,5853,0,0,AL MARMOOM,المرموم
1979,5853,0,0,AL MARMOOM,المرموم
1980,5853,0,0,AL MARMOOM,المرموم
1981,5853,0,0,AL MARMOOM,المرموم
1982,5853,0,0,AL MARMOOM,المرموم
1983,5853,0,0,AL MARMOOM,المرموم
1984,5853,0,0,AL MARMOOM,المرموم
1985,5853,0,0,AL MARMOOM,المرموم
1986,5853,0,0,AL MARMOOM,المرموم
1987,5853,0,0,AL MARMOOM,المرموم
1988,5853,0,0,AL MARMOOM,المرموم
1989,5853,1,1,AL MARMOOM,المرموم
1990,5853,0,1,AL MARMOOM,المرموم
1991,5853,1,2,AL MARMOOM,المرموم
1992,5853,1,3,AL MARMOOM,المرموم
1993,5853,1,4,AL MARMOOM,المرموم
1994,5853,0,4,AL MARMOOM,المرموم
1995,5853,0,4,AL MARMOOM,المرموم
1996,5853,0,4,AL MARMOOM,المرموم
1997,5853,0,4,AL MARMOOM,المرموم
1998,5853,1,5,AL MARMOOM,المرموم
1999,5853,1,6,AL MARMOOM,المرموم
2000,5853,2,8,AL MARMOOM,المرموم
2001,5853,0,8,AL MARMOOM,المرموم
2002,5853,0,8,AL MARMOOM,المرموم
2003,5853,0,8,AL MARMOOM,المرموم
2004,5853,1,9,AL MARMOOM,المرموم
2005,5853,2,11,AL MARMOOM,المرموم
2006,5853,1,12,AL MARMOOM,المرموم
2007,5853,4,16,AL MARMOOM,المرموم
2008,5853,0,16,AL MARMOOM,المرموم
2009,5853,1,17,AL MARMOOM,المرموم
2010,5853,2,19,AL MARMOOM,المرموم
2011,5853,3,22,AL MARMOOM,المرموم
2012,5853,3,25,AL MARMOOM,المرموم
2013,5853,3,28,AL MARMOOM,المرموم
2014,5853,4,32,AL MARMOOM,المرموم
2015,5853,4,36,AL MARMOOM,المرموم
2016,5853,1,37,AL MARMOOM,المرموم
2017,5853,3,40,AL MARMOOM,المرموم
2018,5853,3,43,AL MARMOOM,المرموم
2019,5853,4,47,AL MARMOOM,المرموم
2020,5853,12,59,AL MARMOOM,المرموم
2021,5853,0,59,AL MARMOOM,المرموم
1963,5893,10,10,AL MURAQQABAT,المرقبات
1964,5893,1,11,AL MURAQQABAT,المرقبات
1965,5893,0,11,AL MURAQQABAT,المرقبات
1966,5893,2,13,AL MURAQQABAT,المرقبات
1967,5893,0,13,AL MURAQQABAT,المرقبات
1968,5893,1,14,AL MURAQQABAT,المرقبات
1969,5893,1,15,AL MURAQQABAT,المرقبات
1970,5893,0,15,AL MURAQQABAT,المرقبات
1971,5893,1,16,AL MURAQQABAT,المرقبات
1972,5893,6,22,AL MURAQQABAT,المرقبات
1973,5893,1,23,AL MURAQQABAT,المرقبات
1974,5893,1,24,AL MURAQQABAT,المرقبات
1975,5893,2,26,AL MURAQQABAT,المرقبات
1976,5893,3,29,AL MURAQQABAT,المرقبات
1977,5893,3,32,AL MURAQQABAT,المرقبات
1978,5893,6,38,AL MURAQQABAT,المرقبات
1979,5893,3,41,AL MURAQQABAT,المرقبات
1980,5893,8,49,AL MURAQQABAT,المرقبات
1981,5893,6,55,AL MURAQQABAT,المرقبات
1982,5893,6,61,AL MURAQQABAT,المرقبات
1983,5893,5,66,AL MURAQQABAT,المرقبات
1984,5893,6,72,AL MURAQQABAT,المرقبات
1985,5893,4,76,AL MURAQQABAT,المرقبات
1986,5893,11,87,AL MURAQQABAT,المرقبات
1987,5893,9,96,AL MURAQQABAT,المرقبات
1988,5893,10,106,AL MURAQQABAT,المرقبات
1989,5893,12,118,AL MURAQQABAT,المرقبات
1990,5893,19,137,AL MURAQQABAT,المرقبات
1991,5893,14,151,AL MURAQQABAT,المرقبات
1992,5893,17,168,AL MURAQQABAT,المرقبات
1993,5893,22,190,AL MURAQQABAT,المرقبات
1994,5893,14,204,AL MURAQQABAT,المرقبات
1995,5893,17,221,AL MURAQQABAT,المرقبات
1996,5893,21,242,AL MURAQQABAT,المرقبات
1997,5893,21,263,AL MURAQQABAT,المرقبات
1998,5893,18,281,AL MURAQQABAT,المرقبات
1999,5893,20,301,AL MURAQQABAT,المرقبات
2000,5893,36,337,AL MURAQQABAT,المرقبات
2001,5893,30,367,AL MURAQQABAT,المرقبات
2002,5893,37,404,AL MURAQQABAT,المرقبات
2003,5893,31,435,AL MURAQQABAT,المرقبات
2004,5893,54,489,AL MURAQQABAT,المرقبات
2005,5893,56,545,AL MURAQQABAT,المرقبات
2006,5893,39,584,AL MURAQQABAT,المرقبات
2007,5893,54,638,AL MURAQQABAT,المرقبات
2008,5893,41,679,AL MURAQQABAT,المرقبات
2009,5893,39,718,AL MURAQQABAT,المرقبات
2010,5893,47,765,AL MURAQQABAT,المرقبات
2011,5893,48,813,AL MURAQQABAT,المرقبات
2012,5893,48,861,AL MURAQQABAT,المرقبات
2013,5893,74,935,AL MURAQQABAT,المرقبات
2014,5893,60,995,AL MURAQQABAT,المرقبات
2015,5893,64,1059,AL MURAQQABAT,المرقبات
2016,5893,62,1121,AL MURAQQABAT,المرقبات
2017,5893,73,1194,AL MURAQQABAT,المرقبات
2018,5893,86,1280,AL MURAQQABAT,المرقبات
2019,5893,154,1434,AL MURAQQABAT,المرقبات
2020,5893,201,1635,AL MURAQQABAT,المرقبات
2021,5893,0,1635,AL MURAQQABAT,المرقبات
1963,5933,0,0,WADI AL SAFA 6,وادي الصفا 6
1964,5933,0,0,WADI AL SAFA 6,وادي الصفا 6
1965,5933,0,0,WADI AL SAFA 6,وادي الصفا 6
1966,5933,0,0,WADI AL SAFA 6,وادي الصفا 6
1967,5933,0,0,WADI AL SAFA 6,وادي الصفا 6
1968,5933,0,0,WADI AL SAFA 6,وادي الصفا 6
1969,5933,0,0,WADI AL SAFA 6,وادي الصفا 6
1970,5933,0,0,WADI AL SAFA 6,وادي الصفا 6
1971,5933,0,0,WADI AL SAFA 6,وادي الصفا 6
1972,5933,0,0,WADI AL SAFA 6,وادي الصفا 6
1973,5933,0,0,WADI AL SAFA 6,وادي الصفا 6
1974,5933,0,0,WADI AL SAFA 6,وادي الصفا 6
1975,5933,0,0,WADI AL SAFA 6,وادي الصفا 6
1976,5933,0,0,WADI AL SAFA 6,وادي الصفا 6
1977,5933,0,0,WADI AL SAFA 6,وادي الصفا 6
1978,5933,0,0,WADI AL SAFA 6,وادي الصفا 6
1979,5933,0,0,WADI AL SAFA 6,وادي الصفا 6
1980,5933,0,0,WADI AL SAFA 6,وادي الصفا 6
1981,5933,0,0,WADI AL SAFA 6,وادي الصفا 6
1982,5933,0,0,WADI AL SAFA 6,وادي الصفا 6
1983,5933,0,0,WADI AL SAFA 6,وادي الصفا 6
1984,5933,0,0,WADI AL SAFA 6,وادي الصفا 6
1985,5933,0,0,WADI AL SAFA 6,وادي الصفا 6
1986,5933,0,0,WADI AL SAFA 6,وادي الصفا 6
1987,5933,0,0,WADI AL SAFA 6,وادي الصفا 6
1988,5933,0,0,WADI AL SAFA 6,وادي الصفا 6
1989,5933,0,0,WADI AL SAFA 6,وادي الصفا 6
1990,5933,0,0,WADI AL SAFA 6,وادي الصفا 6
1991,5933,0,0,WADI AL SAFA 6,وادي الصفا 6
1992,5933,0,0,WADI AL SAFA 6,وادي الصفا 6
1993,5933,0,0,WADI AL SAFA 6,وادي الصفا 6
1994,5933,0,0,WADI AL SAFA 6,وادي الصفا 6
1995,5933,0,0,WADI AL SAFA 6,وادي الصفا 6
1996,5933,0,0,WADI AL SAFA 6,وادي الصفا 6
1997,5933,0,0,WADI AL SAFA 6,وادي الصفا 6
1998,5933,0,0,WADI AL SAFA 6,وادي الصفا 6
1999,5933,0,0,WADI AL SAFA 6,وادي الصفا 6
2000,5933,0,0,WADI AL SAFA 6,وادي الصفا 6
2001,5933,0,0,WADI AL SAFA 6,وادي الصفا 6
2002,5933,0,0,WADI AL SAFA 6,وادي الصفا 6
2003,5933,0,0,WADI AL SAFA 6,وادي الصفا 6
2004,5933,0,0,WADI AL SAFA 6,وادي الصفا 6
2005,5933,2,2,WADI AL SAFA 6,وادي الصفا 6
2006,5933,2,4,WADI AL SAFA 6,وادي الصفا 6
2007,5933,1,5,WADI AL SAFA 6,وادي الصفا 6
2008,5933,0,5,WADI AL SAFA 6,وادي الصفا 6
2009,5933,0,5,WADI AL SAFA 6,وادي الصفا 6
2010,5933,0,5,WADI AL SAFA 6,وادي الصفا 6
2011,5933,0,5,WADI AL SAFA 6,وادي الصفا 6
2012,5933,0,5,WADI AL SAFA 6,وادي الصفا 6
2013,5933,1,6,WADI AL SAFA 6,وادي الصفا 6
2014,5933,3,9,WADI AL SAFA 6,وادي الصفا 6
2015,5933,0,9,WADI AL SAFA 6,وادي الصفا 6
2016,5933,1,10,WADI AL SAFA 6,وادي الصفا 6
2017,5933,1,11,WADI AL SAFA 6,وادي الصفا 6
2018,5933,3,14,WADI AL SAFA 6,وادي الصفا 6
2019,5933,9,23,WADI AL SAFA 6,وادي الصفا 6
2020,5933,31,54,WADI AL SAFA 6,وادي الصفا 6
2021,5933,0,54,WADI AL SAFA 6,وادي الصفا 6
1963,6013,0,0,UMM HURAIR SECOND,أم هرير الثانية
1964,6013,0,0,UMM HURAIR SECOND,أم هرير الثانية
1965,6013,0,0,UMM HURAIR SECOND,أم هرير الثانية
1966,6013,0,0,UMM HURAIR SECOND,أم هرير الثانية
1967,6013,0,0,UMM HURAIR SECOND,أم هرير الثانية
1968,6013,1,1,UMM HURAIR SECOND,أم هرير الثانية
1969,6013,0,1,UMM HURAIR SECOND,أم هرير الثانية
1970,6013,0,1,UMM HURAIR SECOND,أم هرير الثانية
1971,6013,0,1,UMM HURAIR SECOND,أم هرير الثانية
1972,6013,0,1,UMM HURAIR SECOND,أم هرير الثانية
1973,6013,0,1,UMM HURAIR SECOND,أم هرير الثانية
1974,6013,0,1,UMM HURAIR SECOND,أم هرير الثانية
1975,6013,0,1,UMM HURAIR SECOND,أم هرير الثانية
1976,6013,0,1,UMM HURAIR SECOND,أم هرير الثانية
1977,6013,0,1,UMM HURAIR SECOND,أم هرير الثانية
1978,6013,0,1,UMM HURAIR SECOND,أم هرير الثانية
1979,6013,0,1,UMM HURAIR SECOND,أم هرير الثانية
1980,6013,0,1,UMM HURAIR SECOND,أم هرير الثانية
1981,6013,0,1,UMM HURAIR SECOND,أم هرير الثانية
1982,6013,1,2,UMM HURAIR SECOND,أم هرير الثانية
1983,6013,0,2,UMM HURAIR SECOND,أم هرير الثانية
1984,6013,0,2,UMM HURAIR SECOND,أم هرير الثانية
1985,6013,1,3,UMM HURAIR SECOND,أم هرير الثانية
1986,6013,0,3,UMM HURAIR SECOND,أم هرير الثانية
1987,6013,0,3,UMM HURAIR SECOND,أم هرير الثانية
1988,6013,0,3,UMM HURAIR SECOND,أم هرير الثانية
1989,6013,2,5,UMM HURAIR SECOND,أم هرير الثانية
1990,6013,0,5,UMM HURAIR SECOND,أم هرير الثانية
1991,6013,2,7,UMM HURAIR SECOND,أم هرير الثانية
1992,6013,1,8,UMM HURAIR SECOND,أم هرير الثانية
1993,6013,1,9,UMM HURAIR SECOND,أم هرير الثانية
1994,6013,2,11,UMM HURAIR SECOND,أم هرير الثانية
1995,6013,1,12,UMM HURAIR SECOND,أم هرير الثانية
1996,6013,4,16,UMM HURAIR SECOND,أم هرير الثانية
1997,6013,1,17,UMM HURAIR SECOND,أم هرير الثانية
1998,6013,4,21,UMM HURAIR SECOND,أم هرير الثانية
1999,6013,4,25,UMM HURAIR SECOND,أم هرير الثانية
2000,6013,4,29,UMM HURAIR SECOND,أم هرير الثانية
2001,6013,2,31,UMM HURAIR SECOND,أم هرير الثانية
2002,6013,5,36,UMM HURAIR SECOND,أم هرير الثانية
2003,6013,6,42,UMM HURAIR SECOND,أم هرير الثانية
2004,6013,5,47,UMM HURAIR SECOND,أم هرير الثانية
2005,6013,7,54,UMM HURAIR SECOND,أم هرير الثانية
2006,6013,8,62,UMM HURAIR SECOND,أم هرير الثانية
2007,6013,6,68,UMM HURAIR SECOND,أم هرير الثانية
2008,6013,8,76,UMM HURAIR SECOND,أم هرير الثانية
2009,6013,4,80,UMM HURAIR SECOND,أم هرير الثانية
2010,6013,4,84,UMM HURAIR SECOND,أم هرير الثانية
2011,6013,8,92,UMM HURAIR SECOND,أم هرير الثانية
2012,6013,8,100,UMM HURAIR SECOND,أم هرير الثانية
2013,6013,15,115,UMM HURAIR SECOND,أم هرير الثانية
2014,6013,13,128,UMM HURAIR SECOND,أم هرير الثانية
2015,6013,14,142,UMM HURAIR SECOND,أم هرير الثانية
2016,6013,12,154,UMM HURAIR SECOND,أم هرير الثانية
2017,6013,10,164,UMM HURAIR SECOND,أم هرير الثانية
2018,6013,24,188,UMM HURAIR SECOND,أم هرير الثانية
2019,6013,33,221,UMM HURAIR SECOND,أم هرير الثانية
2020,6013,75,296,UMM HURAIR SECOND,أم هرير الثانية
2021,6013,0,296,UMM HURAIR SECOND,أم هرير الثانية
1963,6053,27,27,AYAL NASIR,عيال ناصر
1964,6053,8,35,AYAL NASIR,عيال ناصر
1965,6053,5,40,AYAL NASIR,عيال ناصر
1966,6053,4,44,AYAL NASIR,عيال ناصر
1967,6053,3,47,AYAL NASIR,عيال ناصر
1968,6053,2,49,AYAL NASIR,عيال ناصر
1969,6053,2,51,AYAL NASIR,عيال ناصر
1970,6053,6,57,AYAL NASIR,عيال ناصر
1971,6053,5,62,AYAL NASIR,عيال ناصر
1972,6053,2,64,AYAL NASIR,عيال ناصر
1973,6053,9,73,AYAL NASIR,عيال ناصر
1974,6053,13,86,AYAL NASIR,عيال ناصر
1975,6053,15,101,AYAL NASIR,عيال ناصر
1976,6053,14,115,AYAL NASIR,عيال ناصر
1977,6053,10,125,AYAL NASIR,عيال ناصر
1978,6053,19,144,AYAL NASIR,عيال ناصر
1979,6053,26,170,AYAL NASIR,عيال ناصر
1980,6053,32,202,AYAL NASIR,عيال ناصر
1981,6053,22,224,AYAL NASIR,عيال ناصر
1982,6053,32,256,AYAL NASIR,عيال ناصر
1983,6053,42,298,AYAL NASIR,عيال ناصر
1984,6053,26,324,AYAL NASIR,عيال ناصر
1985,6053,21,345,AYAL NASIR,عيال ناصر
1986,6053,46,391,AYAL NASIR,عيال ناصر
1987,6053,29,420,AYAL NASIR,عيال ناصر
1988,6053,46,466,AYAL NASIR,عيال ناصر
1989,6053,49,515,AYAL NASIR,عيال ناصر
1990,6053,49,564,AYAL NASIR,عيال ناصر
1991,6053,61,625,AYAL NASIR,عيال ناصر
1992,6053,59,684,AYAL NASIR,عيال ناصر
1993,6053,51,735,AYAL NASIR,عيال ناصر
1994,6053,63,798,AYAL NASIR,عيال ناصر
1995,6053,61,859,AYAL NASIR,عيال ناصر
1996,6053,67,926,AYAL NASIR,عيال ناصر
1997,6053,51,977,AYAL NASIR,عيال ناصر
1998,6053,47,1024,AYAL NASIR,عيال ناصر
1999,6053,68,1092,AYAL NASIR,عيال ناصر
2000,6053,99,1191,AYAL NASIR,عيال ناصر
2001,6053,96,1287,AYAL NASIR,عيال ناصر
2002,6053,108,1395,AYAL NASIR,عيال ناصر
2003,6053,108,1503,AYAL NASIR,عيال ناصر
2004,6053,118,1621,AYAL NASIR,عيال ناصر
2005,6053,116,1737,AYAL NASIR,عيال ناصر
2006,6053,130,1867,AYAL NASIR,عيال ناصر
2007,6053,93,1960,AYAL NASIR,عيال ناصر
2008,6053,86,2046,AYAL NASIR,عيال ناصر
2009,6053,80,2126,AYAL NASIR,عيال ناصر
2010,6053,62,2188,AYAL NASIR,عيال ناصر
2011,6053,56,2244,AYAL NASIR,عيال ناصر
2012,6053,53,2297,AYAL NASIR,عيال ناصر
2013,6053,56,2353,AYAL NASIR,عيال ناصر
2014,6053,56,2409,AYAL NASIR,عيال ناصر
2015,6053,55,2464,AYAL NASIR,عيال ناصر
2016,6053,41,2505,AYAL NASIR,عيال ناصر
2017,6053,52,2557,AYAL NASIR,عيال ناصر
2018,6053,42,2599,AYAL NASIR,عيال ناصر
2019,6053,66,2665,AYAL NASIR,عيال ناصر
2020,6053,111,2776,AYAL NASIR,عيال ناصر
2021,6053,0,2776,AYAL NASIR,عيال ناصر
1963,6093,0,0,UMM NAHAD THIRD,أم نهد الثالثة
1964,6093,0,0,UMM NAHAD THIRD,أم نهد الثالثة
1965,6093,0,0,UMM NAHAD THIRD,أم نهد الثالثة
1966,6093,0,0,UMM NAHAD THIRD,أم نهد الثالثة
1967,6093,0,0,UMM NAHAD THIRD,أم نهد الثالثة
1968,6093,0,0,UMM NAHAD THIRD,أم نهد الثالثة
1969,6093,0,0,UMM NAHAD THIRD,أم نهد الثالثة
1970,6093,0,0,UMM NAHAD THIRD,أم نهد الثالثة
1971,6093,0,0,UMM NAHAD THIRD,أم نهد الثالثة
1972,6093,0,0,UMM NAHAD THIRD,أم نهد الثالثة
1973,6093,0,0,UMM NAHAD THIRD,أم نهد الثالثة
1974,6093,0,0,UMM NAHAD THIRD,أم نهد الثالثة
1975,6093,0,0,UMM NAHAD THIRD,أم نهد الثالثة
1976,6093,0,0,UMM NAHAD THIRD,أم نهد الثالثة
1977,6093,0,0,UMM NAHAD THIRD,أم نهد الثالثة
1978,6093,0,0,UMM NAHAD THIRD,أم نهد الثالثة
1979,6093,0,0,UMM NAHAD THIRD,أم نهد الثالثة
1980,6093,0,0,UMM NAHAD THIRD,أم نهد الثالثة
1981,6093,0,0,UMM NAHAD THIRD,أم نهد الثالثة
1982,6093,0,0,UMM NAHAD THIRD,أم نهد الثالثة
1983,6093,0,0,UMM NAHAD THIRD,أم نهد الثالثة
1984,6093,0,0,UMM NAHAD THIRD,أم نهد الثالثة
1985,6093,0,0,UMM NAHAD THIRD,أم نهد الثالثة
1986,6093,0,0,UMM NAHAD THIRD,أم نهد الثالثة
1987,6093,0,0,UMM NAHAD THIRD,أم نهد الثالثة
1988,6093,0,0,UMM NAHAD THIRD,أم نهد الثالثة
1989,6093,0,0,UMM NAHAD THIRD,أم نهد الثالثة
1990,6093,0,0,UMM NAHAD THIRD,أم نهد الثالثة
1991,6093,0,0,UMM NAHAD THIRD,أم نهد الثالثة
1992,6093,0,0,UMM NAHAD THIRD,أم نهد الثالثة
1993,6093,0,0,UMM NAHAD THIRD,أم نهد الثالثة
1994,6093,0,0,UMM NAHAD THIRD,أم نهد الثالثة
1995,6093,0,0,UMM NAHAD THIRD,أم نهد الثالثة
1996,6093,0,0,UMM NAHAD THIRD,أم نهد الثالثة
1997,6093,0,0,UMM NAHAD THIRD,أم نهد الثالثة
1998,6093,0,0,UMM NAHAD THIRD,أم نهد الثالثة
1999,6093,0,0,UMM NAHAD THIRD,أم نهد الثالثة
2000,6093,0,0,UMM NAHAD THIRD,أم نهد الثالثة
2001,6093,0,0,UMM NAHAD THIRD,أم نهد الثالثة
2002,6093,0,0,UMM NAHAD THIRD,أم نهد الثالثة
2003,6093,0,0,UMM NAHAD THIRD,أم نهد الثالثة
2004,6093,1,1,UMM NAHAD THIRD,أم نهد الثالثة
2005,6093,0,1,UMM NAHAD THIRD,أم نهد الثالثة
2006,6093,0,1,UMM NAHAD THIRD,أم نهد الثالثة
2007,6093,0,1,UMM NAHAD THIRD,أم نهد الثالثة
2008,6093,0,1,UMM NAHAD THIRD,أم نهد الثالثة
2009,6093,0,1,UMM NAHAD THIRD,أم نهد الثالثة
2010,6093,1,2,UMM NAHAD THIRD,أم نهد الثالثة
2011,6093,0,2,UMM NAHAD THIRD,أم نهد الثالثة
2012,6093,0,2,UMM NAHAD THIRD,أم نهد الثالثة
2013,6093,0,2,UMM NAHAD THIRD,أم نهد الثالثة
2014,6093,1,3,UMM NAHAD THIRD,أم نهد الثالثة
2015,6093,0,3,UMM NAHAD THIRD,أم نهد الثالثة
2016,6093,0,3,UMM NAHAD THIRD,أم نهد الثالثة
2017,6093,1,4,UMM NAHAD THIRD,أم نهد الثالثة
2018,6093,2,6,UMM NAHAD THIRD,أم نهد الثالثة
2019,6093,5,11,UMM NAHAD THIRD,أم نهد الثالثة
2020,6093,1,12,UMM NAHAD THIRD,أم نهد الثالثة
2021,6093,0,12,UMM NAHAD THIRD,أم نهد الثالثة
1963,6133,0,0,AL THANYAH  FOURTH,الثنيه الرابعة
1964,6133,0,0,AL THANYAH  FOURTH,الثنيه الرابعة
1965,6133,0,0,AL THANYAH  FOURTH,الثنيه الرابعة
1966,6133,0,0,AL THANYAH  FOURTH,الثنيه الرابعة
1967,6133,0,0,AL THANYAH  FOURTH,الثنيه الرابعة
1968,6133,0,0,AL THANYAH  FOURTH,الثنيه الرابعة
1969,6133,0,0,AL THANYAH  FOURTH,الثنيه الرابعة
1970,6133,0,0,AL THANYAH  FOURTH,الثنيه الرابعة
1971,6133,0,0,AL THANYAH  FOURTH,الثنيه الرابعة
1972,6133,0,0,AL THANYAH  FOURTH,الثنيه الرابعة
1973,6133,0,0,AL THANYAH  FOURTH,الثنيه الرابعة
1974,6133,0,0,AL THANYAH  FOURTH,الثنيه الرابعة
1975,6133,0,0,AL THANYAH  FOURTH,الثنيه الرابعة
1976,6133,0,0,AL THANYAH  FOURTH,الثنيه الرابعة
1977,6133,0,0,AL THANYAH  FOURTH,الثنيه الرابعة
1978,6133,0,0,AL THANYAH  FOURTH,الثنيه الرابعة
1979,6133,0,0,AL THANYAH  FOURTH,الثنيه الرابعة
1980,6133,0,0,AL THANYAH  FOURTH,الثنيه الرابعة
1981,6133,0,0,AL THANYAH  FOURTH,الثنيه الرابعة
1982,6133,0,0,AL THANYAH  FOURTH,الثنيه الرابعة
1983,6133,0,0,AL THANYAH  FOURTH,الثنيه الرابعة
1984,6133,0,0,AL THANYAH  FOURTH,الثنيه الرابعة
1985,6133,0,0,AL THANYAH  FOURTH,الثنيه الرابعة
1986,6133,1,1,AL THANYAH  FOURTH,الثنيه الرابعة
1987,6133,0,1,AL THANYAH  FOURTH,الثنيه الرابعة
1988,6133,0,1,AL THANYAH  FOURTH,الثنيه الرابعة
1989,6133,0,1,AL THANYAH  FOURTH,الثنيه الرابعة
1990,6133,0,1,AL THANYAH  FOURTH,الثنيه الرابعة
1991,6133,0,1,AL THANYAH  FOURTH,الثنيه الرابعة
1992,6133,0,1,AL THANYAH  FOURTH,الثنيه الرابعة
1993,6133,0,1,AL THANYAH  FOURTH,الثنيه الرابعة
1994,6133,0,1,AL THANYAH  FOURTH,الثنيه الرابعة
1995,6133,0,1,AL THANYAH  FOURTH,الثنيه الرابعة
1996,6133,0,1,AL THANYAH  FOURTH,الثنيه الرابعة
1997,6133,1,2,AL THANYAH  FOURTH,الثنيه الرابعة
1998,6133,0,2,AL THANYAH  FOURTH,الثنيه الرابعة
1999,6133,0,2,AL THANYAH  FOURTH,الثنيه الرابعة
2000,6133,0,2,AL THANYAH  FOURTH,الثنيه الرابعة
2001,6133,0,2,AL THANYAH  FOURTH,الثنيه الرابعة
2002,6133,0,2,AL THANYAH  FOURTH,الثنيه الرابعة
2003,6133,0,2,AL THANYAH  FOURTH,الثنيه الرابعة
2004,6133,0,2,AL THANYAH  FOURTH,الثنيه الرابعة
2005,6133,0,2,AL THANYAH  FOURTH,الثنيه الرابعة
2006,6133,4,6,AL THANYAH  FOURTH,الثنيه الرابعة
2007,6133,1,7,AL THANYAH  FOURTH,الثنيه الرابعة
2008,6133,0,7,AL THANYAH  FOURTH,الثنيه الرابعة
2009,6133,3,10,AL THANYAH  FOURTH,الثنيه الرابعة
2010,6133,3,13,AL THANYAH  FOURTH,الثنيه الرابعة
2011,6133,2,15,AL THANYAH  FOURTH,الثنيه الرابعة
2012,6133,2,17,AL THANYAH  FOURTH,الثنيه الرابعة
2013,6133,1,18,AL THANYAH  FOURTH,الثنيه الرابعة
2014,6133,0,18,AL THANYAH  FOURTH,الثنيه الرابعة
2015,6133,1,19,AL THANYAH  FOURTH,الثنيه الرابعة
2016,6133,3,22,AL THANYAH  FOURTH,الثنيه الرابعة
2017,6133,1,23,AL THANYAH  FOURTH,الثنيه الرابعة
2018,6133,32,55,AL THANYAH  FOURTH,الثنيه الرابعة
2019,6133,34,89,AL THANYAH  FOURTH,الثنيه الرابعة
2020,6133,45,134,AL THANYAH  FOURTH,الثنيه الرابعة
2021,6133,0,134,AL THANYAH  FOURTH,الثنيه الرابعة
1963,6173,0,0,NADD AL SHIBA THIRD,ند الشبا الثالثة
1964,6173,0,0,NADD AL SHIBA THIRD,ند الشبا الثالثة
1965,6173,0,0,NADD AL SHIBA THIRD,ند الشبا الثالثة
1966,6173,0,0,NADD AL SHIBA THIRD,ند الشبا الثالثة
1967,6173,0,0,NADD AL SHIBA THIRD,ند الشبا الثالثة
1968,6173,0,0,NADD AL SHIBA THIRD,ند الشبا الثالثة
1969,6173,0,0,NADD AL SHIBA THIRD,ند الشبا الثالثة
1970,6173,0,0,NADD AL SHIBA THIRD,ند الشبا الثالثة
1971,6173,0,0,NADD AL SHIBA THIRD,ند الشبا الثالثة
1972,6173,0,0,NADD AL SHIBA THIRD,ند الشبا الثالثة
1973,6173,0,0,NADD AL SHIBA THIRD,ند الشبا الثالثة
1974,6173,0,0,NADD AL SHIBA THIRD,ند الشبا الثالثة
1975,6173,0,0,NADD AL SHIBA THIRD,ند الشبا الثالثة
1976,6173,0,0,NADD AL SHIBA THIRD,ند الشبا الثالثة
1977,6173,0,0,NADD AL SHIBA THIRD,ند الشبا الثالثة
1978,6173,0,0,NADD AL SHIBA THIRD,ند الشبا الثالثة
1979,6173,0,0,NADD AL SHIBA THIRD,ند الشبا الثالثة
1980,6173,0,0,NADD AL SHIBA THIRD,ند الشبا الثالثة
1981,6173,0,0,NADD AL SHIBA THIRD,ند الشبا الثالثة
1982,6173,0,0,NADD AL SHIBA THIRD,ند الشبا الثالثة
1983,6173,0,0,NADD AL SHIBA THIRD,ند الشبا الثالثة
1984,6173,0,0,NADD AL SHIBA THIRD,ند الشبا الثالثة
1985,6173,0,0,NADD AL SHIBA THIRD,ند الشبا الثالثة
1986,6173,0,0,NADD AL SHIBA THIRD,ند الشبا الثالثة
1987,6173,0,0,NADD AL SHIBA THIRD,ند الشبا الثالثة
1988,6173,0,0,NADD AL SHIBA THIRD,ند الشبا الثالثة
1989,6173,0,0,NADD AL SHIBA THIRD,ند الشبا الثالثة
1990,6173,0,0,NADD AL SHIBA THIRD,ند الشبا الثالثة
1991,6173,2,2,NADD AL SHIBA THIRD,ند الشبا الثالثة
1992,6173,1,3,NADD AL SHIBA THIRD,ند الشبا الثالثة
1993,6173,1,4,NADD AL SHIBA THIRD,ند الشبا الثالثة
1994,6173,0,4,NADD AL SHIBA THIRD,ند الشبا الثالثة
1995,6173,0,4,NADD AL SHIBA THIRD,ند الشبا الثالثة
1996,6173,0,4,NADD AL SHIBA THIRD,ند الشبا الثالثة
1997,6173,0,4,NADD AL SHIBA THIRD,ند الشبا الثالثة
1998,6173,0,4,NADD AL SHIBA THIRD,ند الشبا الثالثة
1999,6173,0,4,NADD AL SHIBA THIRD,ند الشبا الثالثة
2000,6173,1,5,NADD AL SHIBA THIRD,ند الشبا الثالثة
2001,6173,0,5,NADD AL SHIBA THIRD,ند الشبا الثالثة
2002,6173,0,5,NADD AL SHIBA THIRD,ند الشبا الثالثة
2003,6173,0,5,NADD AL SHIBA THIRD,ند الشبا الثالثة
2004,6173,3,8,NADD AL SHIBA THIRD,ند الشبا الثالثة
2005,6173,0,8,NADD AL SHIBA THIRD,ند الشبا الثالثة
2006,6173,4,12,NADD AL SHIBA THIRD,ند الشبا الثالثة
2007,6173,1,13,NADD AL SHIBA THIRD,ند الشبا الثالثة
2008,6173,0,13,NADD AL SHIBA THIRD,ند الشبا الثالثة
2009,6173,1,14,NADD AL SHIBA THIRD,ند الشبا الثالثة
2010,6173,1,15,NADD AL SHIBA THIRD,ند الشبا الثالثة
2011,6173,1,16,NADD AL SHIBA THIRD,ند الشبا الثالثة
2012,6173,1,17,NADD AL SHIBA THIRD,ند الشبا الثالثة
2013,6173,2,19,NADD AL SHIBA THIRD,ند الشبا الثالثة
2014,6173,3,22,NADD AL SHIBA THIRD,ند الشبا الثالثة
2015,6173,5,27,NADD AL SHIBA THIRD,ند الشبا الثالثة
2016,6173,4,31,NADD AL SHIBA THIRD,ند الشبا الثالثة
2017,6173,6,37,NADD AL SHIBA THIRD,ند الشبا الثالثة
2018,6173,5,42,NADD AL SHIBA THIRD,ند الشبا الثالثة
2019,6173,7,49,NADD AL SHIBA THIRD,ند الشبا الثالثة
2020,6173,29,78,NADD AL SHIBA THIRD,ند الشبا الثالثة
2021,6173,0,78,NADD AL SHIBA THIRD,ند الشبا الثالثة
1963,6213,29,29,AL RAS,الراس
1964,6213,1,30,AL RAS,الراس
1965,6213,0,30,AL RAS,الراس
1966,6213,2,32,AL RAS,الراس
1967,6213,2,34,AL RAS,الراس
1968,6213,0,34,AL RAS,الراس
1969,6213,0,34,AL RAS,الراس
1970,6213,3,37,AL RAS,الراس
1971,6213,4,41,AL RAS,الراس
1972,6213,2,43,AL RAS,الراس
1973,6213,3,46,AL RAS,الراس
1974,6213,4,50,AL RAS,الراس
1975,6213,5,55,AL RAS,الراس
1976,6213,1,56,AL RAS,الراس
1977,6213,7,63,AL RAS,الراس
1978,6213,5,68,AL RAS,الراس
1979,6213,7,75,AL RAS,الراس
1980,6213,6,81,AL RAS,الراس
1981,6213,8,89,AL RAS,الراس
1982,6213,5,94,AL RAS,الراس
1983,6213,11,105,AL RAS,الراس
1984,6213,9,114,AL RAS,الراس
1985,6213,4,118,AL RAS,الراس
1986,6213,6,124,AL RAS,الراس
1987,6213,6,130,AL RAS,الراس
1988,6213,9,139,AL RAS,الراس
1989,6213,14,153,AL RAS,الراس
1990,6213,15,168,AL RAS,الراس
1991,6213,9,177,AL RAS,الراس
1992,6213,12,189,AL RAS,الراس
1993,6213,9,198,AL RAS,الراس
1994,6213,15,213,AL RAS,الراس
1995,6213,13,226,AL RAS,الراس
1996,6213,17,243,AL RAS,الراس
1997,6213,24,267,AL RAS,الراس
1998,6213,17,284,AL RAS,الراس
1999,6213,9,293,AL RAS,الراس
2000,6213,21,314,AL RAS,الراس
2001,6213,24,338,AL RAS,الراس
2002,6213,30,368,AL RAS,الراس
2003,6213,25,393,AL RAS,الراس
2004,6213,33,426,AL RAS,الراس
2005,6213,32,458,AL RAS,الراس
2006,6213,37,495,AL RAS,الراس
2007,6213,30,525,AL RAS,الراس
2008,6213,22,547,AL RAS,الراس
2009,6213,27,574,AL RAS,الراس
2010,6213,43,617,AL RAS,الراس
2011,6213,63,680,AL RAS,الراس
2012,6213,58,738,AL RAS,الراس
2013,6213,61,799,AL RAS,الراس
2014,6213,60,859,AL RAS,الراس
2015,6213,65,924,AL RAS,الراس
2016,6213,58,982,AL RAS,الراس
2017,6213,65,1047,AL RAS,الراس
2018,6213,60,1107,AL RAS,الراس
2019,6213,69,1176,AL RAS,الراس
2020,6213,72,1248,AL RAS,الراس
2021,6213,0,1248,AL RAS,الراس
1963,6253,6,6,AL DAGHAYA,الضغاية
1964,6253,1,7,AL DAGHAYA,الضغاية
1965,6253,0,7,AL DAGHAYA,الضغاية
1966,6253,0,7,AL DAGHAYA,الضغاية
1967,6253,1,8,AL DAGHAYA,الضغاية
1968,6253,1,9,AL DAGHAYA,الضغاية
1969,6253,0,9,AL DAGHAYA,الضغاية
1970,6253,1,10,AL DAGHAYA,الضغاية
1971,6253,1,11,AL DAGHAYA,الضغاية
1972,6253,2,13,AL DAGHAYA,الضغاية
1973,6253,0,13,AL DAGHAYA,الضغاية
1974,6253,0,13,AL DAGHAYA,الضغاية
1975,6253,3,16,AL DAGHAYA,الضغاية
1976,6253,3,19,AL DAGHAYA,الضغاية
1977,6253,1,20,AL DAGHAYA,الضغاية
1978,6253,2,22,AL DAGHAYA,الضغاية
1979,6253,4,26,AL DAGHAYA,الضغاية
1980,6253,4,30,AL DAGHAYA,الضغاية
1981,6253,10,40,AL DAGHAYA,الضغاية
1982,6253,9,49,AL DAGHAYA,الضغاية
1983,6253,9,58,AL DAGHAYA,الضغاية
1984,6253,5,63,AL DAGHAYA,الضغاية
1985,6253,3,66,AL DAGHAYA,الضغاية
1986,6253,5,71,AL DAGHAYA,الضغاية
1987,6253,7,78,AL DAGHAYA,الضغاية
1988,6253,7,85,AL DAGHAYA,الضغاية
1989,6253,15,100,AL DAGHAYA,الضغاية
1990,6253,15,115,AL DAGHAYA,الضغاية
1991,6253,10,125,AL DAGHAYA,الضغاية
1992,6253,11,136,AL DAGHAYA,الضغاية
1993,6253,16,152,AL DAGHAYA,الضغاية
1994,6253,18,170,AL DAGHAYA,الضغاية
1995,6253,9,179,AL DAGHAYA,الضغاية
1996,6253,7,186,AL DAGHAYA,الضغاية
1997,6253,6,192,AL DAGHAYA,الضغاية
1998,6253,18,210,AL DAGHAYA,الضغاية
1999,6253,9,219,AL DAGHAYA,الضغاية
2000,6253,29,248,AL DAGHAYA,الضغاية
2001,6253,28,276,AL DAGHAYA,الضغاية
2002,6253,33,309,AL DAGHAYA,الضغاية
2003,6253,34,343,AL DAGHAYA,الضغاية
2004,6253,25,368,AL DAGHAYA,الضغاية
2005,6253,30,398,AL DAGHAYA,الضغاية
2006,6253,38,436,AL DAGHAYA,الضغاية
2007,6253,39,475,AL DAGHAYA,الضغاية
2008,6253,25,500,AL DAGHAYA,الضغاية
2009,6253,18,518,AL DAGHAYA,الضغاية
2010,6253,84,602,AL DAGHAYA,الضغاية
2011,6253,68,670,AL DAGHAYA,الضغاية
2012,6253,49,719,AL DAGHAYA,الضغاية
2013,6253,61,780,AL DAGHAYA,الضغاية
2014,6253,72,852,AL DAGHAYA,الضغاية
2015,6253,57,909,AL DAGHAYA,الضغاية
2016,6253,57,966,AL DAGHAYA,الضغاية
2017,6253,79,1045,AL DAGHAYA,الضغاية
2018,6253,67,1112,AL DAGHAYA,الضغاية
2019,6253,122,1234,AL DAGHAYA,الضغاية
2020,6253,97,1331,AL DAGHAYA,الضغاية
2021,6253,0,1331,AL DAGHAYA,الضغاية
1963,6293,0,0,JABAL ALI FIRST,جبل علي الأولى
1964,6293,0,0,JABAL ALI FIRST,جبل علي الأولى
1965,6293,0,0,JABAL ALI FIRST,جبل علي الأولى
1966,6293,0,0,JABAL ALI FIRST,جبل علي الأولى
1967,6293,0,0,JABAL ALI FIRST,جبل علي الأولى
1968,6293,0,0,JABAL ALI FIRST,جبل علي الأولى
1969,6293,0,0,JABAL ALI FIRST,جبل علي الأولى
1970,6293,0,0,JABAL ALI FIRST,جبل علي الأولى
1971,6293,0,0,JABAL ALI FIRST,جبل علي الأولى
1972,6293,0,0,JABAL ALI FIRST,جبل علي الأولى
1973,6293,0,0,JABAL ALI FIRST,جبل علي الأولى
1974,6293,1,1,JABAL ALI FIRST,جبل علي الأولى
1975,6293,1,2,JABAL ALI FIRST,جبل علي الأولى
1976,6293,4,6,JABAL ALI FIRST,جبل علي الأولى
1977,6293,1,7,JABAL ALI FIRST,جبل علي الأولى
1978,6293,0,7,JABAL ALI FIRST,جبل علي الأولى
1979,6293,0,7,JABAL ALI FIRST,جبل علي الأولى
1980,6293,4,11,JABAL ALI FIRST,جبل علي الأولى
1981,6293,2,13,JABAL ALI FIRST,جبل علي الأولى
1982,6293,1,14,JABAL ALI FIRST,جبل علي الأولى
1983,6293,4,18,JABAL ALI FIRST,جبل علي الأولى
1984,6293,4,22,JABAL ALI FIRST,جبل علي الأولى
1985,6293,0,22,JABAL ALI FIRST,جبل علي الأولى
1986,6293,3,25,JABAL ALI FIRST,جبل علي الأولى
1987,6293,0,25,JABAL ALI FIRST,جبل علي الأولى
1988,6293,4,29,JABAL ALI FIRST,جبل علي الأولى
1989,6293,7,36,JABAL ALI FIRST,جبل علي الأولى
1990,6293,1,37,JABAL ALI FIRST,جبل علي الأولى
1991,6293,2,39,JABAL ALI FIRST,جبل علي الأولى
1992,6293,1,40,JABAL ALI FIRST,جبل علي الأولى
1993,6293,4,44,JABAL ALI FIRST,جبل علي الأولى
1994,6293,3,47,JABAL ALI FIRST,جبل علي الأولى
1995,6293,9,56,JABAL ALI FIRST,جبل علي الأولى
1996,6293,6,62,JABAL ALI FIRST,جبل علي الأولى
1997,6293,8,70,JABAL ALI FIRST,جبل علي الأولى
1998,6293,13,83,JABAL ALI FIRST,جبل علي الأولى
1999,6293,14,97,JABAL ALI FIRST,جبل علي الأولى
2000,6293,15,112,JABAL ALI FIRST,جبل علي الأولى
2001,6293,10,122,JABAL ALI FIRST,جبل علي الأولى
2002,6293,16,138,JABAL ALI FIRST,جبل علي الأولى
2003,6293,13,151,JABAL ALI FIRST,جبل علي الأولى
2004,6293,21,172,JABAL ALI FIRST,جبل علي الأولى
2005,6293,16,188,JABAL ALI FIRST,جبل علي الأولى
2006,6293,20,208,JABAL ALI FIRST,جبل علي الأولى
2007,6293,29,237,JABAL ALI FIRST,جبل علي الأولى
2008,6293,29,266,JABAL ALI FIRST,جبل علي الأولى
2009,6293,13,279,JABAL ALI FIRST,جبل علي الأولى
2010,6293,16,295,JABAL ALI FIRST,جبل علي الأولى
2011,6293,39,334,JABAL ALI FIRST,جبل علي الأولى
2012,6293,16,350,JABAL ALI FIRST,جبل علي الأولى
2013,6293,19,369,JABAL ALI FIRST,جبل علي الأولى
2014,6293,30,399,JABAL ALI FIRST,جبل علي الأولى
2015,6293,24,423,JABAL ALI FIRST,جبل علي الأولى
2016,6293,45,468,JABAL ALI FIRST,جبل علي الأولى
2017,6293,32,500,JABAL ALI FIRST,جبل علي الأولى
2018,6293,30,530,JABAL ALI FIRST,جبل علي الأولى
2019,6293,67,597,JABAL ALI FIRST,جبل علي الأولى
2020,6293,149,746,JABAL ALI FIRST,جبل علي الأولى
2021,6293,0,746,JABAL ALI FIRST,جبل علي الأولى
1963,6333,1,1,JUMEIRA SECOND,جميرا الثانية
1964,6333,0,1,JUMEIRA SECOND,جميرا الثانية
1965,6333,0,1,JUMEIRA SECOND,جميرا الثانية
1966,6333,0,1,JUMEIRA SECOND,جميرا الثانية
1967,6333,0,1,JUMEIRA SECOND,جميرا الثانية
1968,6333,0,1,JUMEIRA SECOND,جميرا الثانية
1969,6333,0,1,JUMEIRA SECOND,جميرا الثانية
1970,6333,0,1,JUMEIRA SECOND,جميرا الثانية
1971,6333,0,1,JUMEIRA SECOND,جميرا الثانية
1972,6333,0,1,JUMEIRA SECOND,جميرا الثانية
1973,6333,0,1,JUMEIRA SECOND,جميرا الثانية
1974,6333,0,1,JUMEIRA SECOND,جميرا الثانية
1975,6333,0,1,JUMEIRA SECOND,جميرا الثانية
1976,6333,0,1,JUMEIRA SECOND,جميرا الثانية
1977,6333,1,2,JUMEIRA SECOND,جميرا الثانية
1978,6333,0,2,JUMEIRA SECOND,جميرا الثانية
1979,6333,0,2,JUMEIRA SECOND,جميرا الثانية
1980,6333,0,2,JUMEIRA SECOND,جميرا الثانية
1981,6333,0,2,JUMEIRA SECOND,جميرا الثانية
1982,6333,0,2,JUMEIRA SECOND,جميرا الثانية
1983,6333,0,2,JUMEIRA SECOND,جميرا الثانية
1984,6333,0,2,JUMEIRA SECOND,جميرا الثانية
1985,6333,0,2,JUMEIRA SECOND,جميرا الثانية
1986,6333,0,2,JUMEIRA SECOND,جميرا الثانية
1987,6333,0,2,JUMEIRA SECOND,جميرا الثانية
1988,6333,0,2,JUMEIRA SECOND,جميرا الثانية
1989,6333,0,2,JUMEIRA SECOND,جميرا الثانية
1990,6333,0,2,JUMEIRA SECOND,جميرا الثانية
1991,6333,0,2,JUMEIRA SECOND,جميرا الثانية
1992,6333,1,3,JUMEIRA SECOND,جميرا الثانية
1993,6333,0,3,JUMEIRA SECOND,جميرا الثانية
1994,6333,0,3,JUMEIRA SECOND,جميرا الثانية
1995,6333,0,3,JUMEIRA SECOND,جميرا الثانية
1996,6333,1,4,JUMEIRA SECOND,جميرا الثانية
1997,6333,2,6,JUMEIRA SECOND,جميرا الثانية
1998,6333,1,7,JUMEIRA SECOND,جميرا الثانية
1999,6333,0,7,JUMEIRA SECOND,جميرا الثانية
2000,6333,1,8,JUMEIRA SECOND,جميرا الثانية
2001,6333,0,8,JUMEIRA SECOND,جميرا الثانية
2002,6333,1,9,JUMEIRA SECOND,جميرا الثانية
2003,6333,0,9,JUMEIRA SECOND,جميرا الثانية
2004,6333,2,11,JUMEIRA SECOND,جميرا الثانية
2005,6333,3,14,JUMEIRA SECOND,جميرا الثانية
2006,6333,0,14,JUMEIRA SECOND,جميرا الثانية
2007,6333,5,19,JUMEIRA SECOND,جميرا الثانية
2008,6333,0,19,JUMEIRA SECOND,جميرا الثانية
2009,6333,3,22,JUMEIRA SECOND,جميرا الثانية
2010,6333,2,24,JUMEIRA SECOND,جميرا الثانية
2011,6333,1,25,JUMEIRA SECOND,جميرا الثانية
2012,6333,8,33,JUMEIRA SECOND,جميرا الثانية
2013,6333,2,35,JUMEIRA SECOND,جميرا الثانية
2014,6333,6,41,JUMEIRA SECOND,جميرا الثانية
2015,6333,4,45,JUMEIRA SECOND,جميرا الثانية
2016,6333,8,53,JUMEIRA SECOND,جميرا الثانية
2017,6333,5,58,JUMEIRA SECOND,جميرا الثانية
2018,6333,9,67,JUMEIRA SECOND,جميرا الثانية
2019,6333,24,91,JUMEIRA SECOND,جميرا الثانية
2020,6333,34,125,JUMEIRA SECOND,جميرا الثانية
2021,6333,0,125,JUMEIRA SECOND,جميرا الثانية
1963,6373,0,0,AL THANYAH FIRST,الثنيه الأولى
1964,6373,0,0,AL THANYAH FIRST,الثنيه الأولى
1965,6373,0,0,AL THANYAH FIRST,الثنيه الأولى
1966,6373,0,0,AL THANYAH FIRST,الثنيه الأولى
1967,6373,0,0,AL THANYAH FIRST,الثنيه الأولى
1968,6373,0,0,AL THANYAH FIRST,الثنيه الأولى
1969,6373,0,0,AL THANYAH FIRST,الثنيه الأولى
1970,6373,0,0,AL THANYAH FIRST,الثنيه الأولى
1971,6373,0,0,AL THANYAH FIRST,الثنيه الأولى
1972,6373,0,0,AL THANYAH FIRST,الثنيه الأولى
1973,6373,1,1,AL THANYAH FIRST,الثنيه الأولى
1974,6373,0,1,AL THANYAH FIRST,الثنيه الأولى
1975,6373,0,1,AL THANYAH FIRST,الثنيه الأولى
1976,6373,0,1,AL THANYAH FIRST,الثنيه الأولى
1977,6373,0,1,AL THANYAH FIRST,الثنيه الأولى
1978,6373,1,2,AL THANYAH FIRST,الثنيه الأولى
1979,6373,0,2,AL THANYAH FIRST,الثنيه الأولى
1980,6373,1,3,AL THANYAH FIRST,الثنيه الأولى
1981,6373,3,6,AL THANYAH FIRST,الثنيه الأولى
1982,6373,1,7,AL THANYAH FIRST,الثنيه الأولى
1983,6373,1,8,AL THANYAH FIRST,الثنيه الأولى
1984,6373,1,9,AL THANYAH FIRST,الثنيه الأولى
1985,6373,2,11,AL THANYAH FIRST,الثنيه الأولى
1986,6373,3,14,AL THANYAH FIRST,الثنيه الأولى
1987,6373,0,14,AL THANYAH FIRST,الثنيه الأولى
1988,6373,2,16,AL THANYAH FIRST,الثنيه الأولى
1989,6373,0,16,AL THANYAH FIRST,الثنيه الأولى
1990,6373,2,18,AL THANYAH FIRST,الثنيه الأولى
1991,6373,0,18,AL THANYAH FIRST,الثنيه الأولى
1992,6373,2,20,AL THANYAH FIRST,الثنيه الأولى
1993,6373,1,21,AL THANYAH FIRST,الثنيه الأولى
1994,6373,2,23,AL THANYAH FIRST,الثنيه الأولى
1995,6373,3,26,AL THANYAH FIRST,الثنيه الأولى
1996,6373,2,28,AL THANYAH FIRST,الثنيه الأولى
1997,6373,6,34,AL THANYAH FIRST,الثنيه الأولى
1998,6373,5,39,AL THANYAH FIRST,الثنيه الأولى
1999,6373,4,43,AL THANYAH FIRST,الثنيه الأولى
2000,6373,2,45,AL THANYAH FIRST,الثنيه الأولى
2001,6373,8,53,AL THANYAH FIRST,الثنيه الأولى
2002,6373,8,61,AL THANYAH FIRST,الثنيه الأولى
2003,6373,7,68,AL THANYAH FIRST,الثنيه الأولى
2004,6373,12,80,AL THANYAH FIRST,الثنيه الأولى
2005,6373,15,95,AL THANYAH FIRST,الثنيه الأولى
2006,6373,15,110,AL THANYAH FIRST,الثنيه الأولى
2007,6373,14,124,AL THANYAH FIRST,الثنيه الأولى
2008,6373,20,144,AL THANYAH FIRST,الثنيه الأولى
2009,6373,13,157,AL THANYAH FIRST,الثنيه الأولى
2010,6373,15,172,AL THANYAH FIRST,الثنيه الأولى
2011,6373,18,190,AL THANYAH FIRST,الثنيه الأولى
2012,6373,26,216,AL THANYAH FIRST,الثنيه الأولى
2013,6373,32,248,AL THANYAH FIRST,الثنيه الأولى
2014,6373,67,315,AL THANYAH FIRST,الثنيه الأولى
2015,6373,52,367,AL THANYAH FIRST,الثنيه الأولى
2016,6373,64,431,AL THANYAH FIRST,الثنيه الأولى
2017,6373,68,499,AL THANYAH FIRST,الثنيه الأولى
2018,6373,66,565,AL THANYAH FIRST,الثنيه الأولى
2019,6373,94,659,AL THANYAH FIRST,الثنيه الأولى
2020,6373,104,763,AL THANYAH FIRST,الثنيه الأولى
2021,6373,0,763,AL THANYAH FIRST,الثنيه الأولى
1963,6413,0,0,AL AWIR FIRST,العوير الأولى
1964,6413,0,0,AL AWIR FIRST,العوير الأولى
1965,6413,0,0,AL AWIR FIRST,العوير الأولى
1966,6413,0,0,AL AWIR FIRST,العوير الأولى
1967,6413,0,0,AL AWIR FIRST,العوير الأولى
1968,6413,0,0,AL AWIR FIRST,العوير الأولى
1969,6413,0,0,AL AWIR FIRST,العوير الأولى
1970,6413,0,0,AL AWIR FIRST,العوير الأولى
1971,6413,0,0,AL AWIR FIRST,العوير الأولى
1972,6413,1,1,AL AWIR FIRST,العوير الأولى
1973,6413,1,2,AL AWIR FIRST,العوير الأولى
1974,6413,2,4,AL AWIR FIRST,العوير الأولى
1975,6413,1,5,AL AWIR FIRST,العوير الأولى
1976,6413,0,5,AL AWIR FIRST,العوير الأولى
1977,6413,0,5,AL AWIR FIRST,العوير الأولى
1978,6413,2,7,AL AWIR FIRST,العوير الأولى
1979,6413,0,7,AL AWIR FIRST,العوير الأولى
1980,6413,3,10,AL AWIR FIRST,العوير الأولى
1981,6413,4,14,AL AWIR FIRST,العوير الأولى
1982,6413,5,19,AL AWIR FIRST,العوير الأولى
1983,6413,4,23,AL AWIR FIRST,العوير الأولى
1984,6413,2,25,AL AWIR FIRST,العوير الأولى
1985,6413,1,26,AL AWIR FIRST,العوير الأولى
1986,6413,5,31,AL AWIR FIRST,العوير الأولى
1987,6413,3,34,AL AWIR FIRST,العوير الأولى
1988,6413,7,41,AL AWIR FIRST,العوير الأولى
1989,6413,8,49,AL AWIR FIRST,العوير الأولى
1990,6413,9,58,AL AWIR FIRST,العوير الأولى
1991,6413,3,61,AL AWIR FIRST,العوير الأولى
1992,6413,4,65,AL AWIR FIRST,العوير الأولى
1993,6413,5,70,AL AWIR FIRST,العوير الأولى
1994,6413,4,74,AL AWIR FIRST,العوير الأولى
1995,6413,3,77,AL AWIR FIRST,العوير الأولى
1996,6413,4,81,AL AWIR FIRST,العوير الأولى
1997,6413,6,87,AL AWIR FIRST,العوير الأولى
1998,6413,1,88,AL AWIR FIRST,العوير الأولى
1999,6413,6,94,AL AWIR FIRST,العوير الأولى
2000,6413,6,100,AL AWIR FIRST,العوير الأولى
2001,6413,3,103,AL AWIR FIRST,العوير الأولى
2002,6413,5,108,AL AWIR FIRST,العوير الأولى
2003,6413,7,115,AL AWIR FIRST,العوير الأولى
2004,6413,9,124,AL AWIR FIRST,العوير الأولى
2005,6413,5,129,AL AWIR FIRST,العوير الأولى
2006,6413,9,138,AL AWIR FIRST,العوير الأولى
2007,6413,10,148,AL AWIR FIRST,العوير الأولى
2008,6413,11,159,AL AWIR FIRST,العوير الأولى
2009,6413,10,169,AL AWIR FIRST,العوير الأولى
2010,6413,16,185,AL AWIR FIRST,العوير الأولى
2011,6413,19,204,AL AWIR FIRST,العوير الأولى
2012,6413,12,216,AL AWIR FIRST,العوير الأولى
2013,6413,5,221,AL AWIR FIRST,العوير الأولى
2014,6413,4,225,AL AWIR FIRST,العوير الأولى
2015,6413,13,238,AL AWIR FIRST,العوير الأولى
2016,6413,5,243,AL AWIR FIRST,العوير الأولى
2017,6413,12,255,AL AWIR FIRST,العوير الأولى
2018,6413,8,263,AL AWIR FIRST,العوير الأولى
2019,6413,13,276,AL AWIR FIRST,العوير الأولى
2020,6413,33,309,AL AWIR FIRST,العوير الأولى
2021,6413,0,309,AL AWIR FIRST,العوير الأولى
1963,6497,0,0,AL YALAYIS 4,اليلايس 4
1964,6497,0,0,AL YALAYIS 4,اليلايس 4
1965,6497,0,0,AL YALAYIS 4,اليلايس 4
1966,6497,0,0,AL YALAYIS 4,اليلايس 4
1967,6497,0,0,AL YALAYIS 4,اليلايس 4
1968,6497,0,0,AL YALAYIS 4,اليلايس 4
1969,6497,0,0,AL YALAYIS 4,اليلايس 4
1970,6497,0,0,AL YALAYIS 4,اليلايس 4
1971,6497,0,0,AL YALAYIS 4,اليلايس 4
1972,6497,0,0,AL YALAYIS 4,اليلايس 4
1973,6497,0,0,AL YALAYIS 4,اليلايس 4
1974,6497,0,0,AL YALAYIS 4,اليلايس 4
1975,6497,0,0,AL YALAYIS 4,اليلايس 4
1976,6497,0,0,AL YALAYIS 4,اليلايس 4
1977,6497,0,0,AL YALAYIS 4,اليلايس 4
1978,6497,0,0,AL YALAYIS 4,اليلايس 4
1979,6497,0,0,AL YALAYIS 4,اليلايس 4
1980,6497,0,0,AL YALAYIS 4,اليلايس 4
1981,6497,0,0,AL YALAYIS 4,اليلايس 4
1982,6497,0,0,AL YALAYIS 4,اليلايس 4
1983,6497,0,0,AL YALAYIS 4,اليلايس 4
1984,6497,0,0,AL YALAYIS 4,اليلايس 4
1985,6497,0,0,AL YALAYIS 4,اليلايس 4
1986,6497,0,0,AL YALAYIS 4,اليلايس 4
1987,6497,0,0,AL YALAYIS 4,اليلايس 4
1988,6497,0,0,AL YALAYIS 4,اليلايس 4
1989,6497,0,0,AL YALAYIS 4,اليلايس 4
1990,6497,0,0,AL YALAYIS 4,اليلايس 4
1991,6497,0,0,AL YALAYIS 4,اليلايس 4
1992,6497,0,0,AL YALAYIS 4,اليلايس 4
1993,6497,0,0,AL YALAYIS 4,اليلايس 4
1994,6497,0,0,AL YALAYIS 4,اليلايس 4
1995,6497,0,0,AL YALAYIS 4,اليلايس 4
1996,6497,0,0,AL YALAYIS 4,اليلايس 4
1997,6497,0,0,AL YALAYIS 4,اليلايس 4
1998,6497,0,0,AL YALAYIS 4,اليلايس 4
1999,6497,0,0,AL YALAYIS 4,اليلايس 4
2000,6497,0,0,AL YALAYIS 4,اليلايس 4
2001,6497,0,0,AL YALAYIS 4,اليلايس 4
2002,6497,0,0,AL YALAYIS 4,اليلايس 4
2003,6497,0,0,AL YALAYIS 4,اليلايس 4
2004,6497,0,0,AL YALAYIS 4,اليلايس 4
2005,6497,0,0,AL YALAYIS 4,اليلايس 4
2006,6497,0,0,AL YALAYIS 4,اليلايس 4
2007,6497,0,0,AL YALAYIS 4,اليلايس 4
2008,6497,0,0,AL YALAYIS 4,اليلايس 4
2009,6497,0,0,AL YALAYIS 4,اليلايس 4
2010,6497,0,0,AL YALAYIS 4,اليلايس 4
2011,6497,0,0,AL YALAYIS 4,اليلايس 4
2012,6497,0,0,AL YALAYIS 4,اليلايس 4
2013,6497,0,0,AL YALAYIS 4,اليلايس 4
2014,6497,0,0,AL YALAYIS 4,اليلايس 4
2015,6497,0,0,AL YALAYIS 4,اليلايس 4
2016,6497,0,0,AL YALAYIS 4,اليلايس 4
2017,6497,0,0,AL YALAYIS 4,اليلايس 4
2018,6497,0,0,AL YALAYIS 4,اليلايس 4
2019,6497,1,1,AL YALAYIS 4,اليلايس 4
2020,6497,2,3,AL YALAYIS 4,اليلايس 4
2021,6497,0,3,AL YALAYIS 4,اليلايس 4
1963,6537,0,0,"AL WARQA'A SECOND",الورقاء الثانية
1964,6537,0,0,"AL WARQA'A SECOND",الورقاء الثانية
1965,6537,0,0,"AL WARQA'A SECOND",الورقاء الثانية
1966,6537,0,0,"AL WARQA'A SECOND",الورقاء الثانية
1967,6537,0,0,"AL WARQA'A SECOND",الورقاء الثانية
1968,6537,0,0,"AL WARQA'A SECOND",الورقاء الثانية
1969,6537,0,0,"AL WARQA'A SECOND",الورقاء الثانية
1970,6537,0,0,"AL WARQA'A SECOND",الورقاء الثانية
1971,6537,1,1,"AL WARQA'A SECOND",الورقاء الثانية
1972,6537,0,1,"AL WARQA'A SECOND",الورقاء الثانية
1973,6537,0,1,"AL WARQA'A SECOND",الورقاء الثانية
1974,6537,0,1,"AL WARQA'A SECOND",الورقاء الثانية
1975,6537,0,1,"AL WARQA'A SECOND",الورقاء الثانية
1976,6537,0,1,"AL WARQA'A SECOND",الورقاء الثانية
1977,6537,0,1,"AL WARQA'A SECOND",الورقاء الثانية
1978,6537,0,1,"AL WARQA'A SECOND",الورقاء الثانية
1979,6537,0,1,"AL WARQA'A SECOND",الورقاء الثانية
1980,6537,0,1,"AL WARQA'A SECOND",الورقاء الثانية
1981,6537,0,1,"AL WARQA'A SECOND",الورقاء الثانية
1982,6537,0,1,"AL WARQA'A SECOND",الورقاء الثانية
1983,6537,1,2,"AL WARQA'A SECOND",الورقاء الثانية
1984,6537,0,2,"AL WARQA'A SECOND",الورقاء الثانية
1985,6537,0,2,"AL WARQA'A SECOND",الورقاء الثانية
1986,6537,0,2,"AL WARQA'A SECOND",الورقاء الثانية
1987,6537,0,2,"AL WARQA'A SECOND",الورقاء الثانية
1988,6537,0,2,"AL WARQA'A SECOND",الورقاء الثانية
1989,6537,0,2,"AL WARQA'A SECOND",الورقاء الثانية
1990,6537,0,2,"AL WARQA'A SECOND",الورقاء الثانية
1991,6537,0,2,"AL WARQA'A SECOND",الورقاء الثانية
1992,6537,0,2,"AL WARQA'A SECOND",الورقاء الثانية
1993,6537,0,2,"AL WARQA'A SECOND",الورقاء الثانية
1994,6537,0,2,"AL WARQA'A SECOND",الورقاء الثانية
1995,6537,0,2,"AL WARQA'A SECOND",الورقاء الثانية
1996,6537,0,2,"AL WARQA'A SECOND",الورقاء الثانية
1997,6537,0,2,"AL WARQA'A SECOND",الورقاء الثانية
1998,6537,0,2,"AL WARQA'A SECOND",الورقاء الثانية
1999,6537,0,2,"AL WARQA'A SECOND",الورقاء الثانية
2000,6537,0,2,"AL WARQA'A SECOND",الورقاء الثانية
2001,6537,0,2,"AL WARQA'A SECOND",الورقاء الثانية
2002,6537,0,2,"AL WARQA'A SECOND",الورقاء الثانية
2003,6537,0,2,"AL WARQA'A SECOND",الورقاء الثانية
2004,6537,0,2,"AL WARQA'A SECOND",الورقاء الثانية
2005,6537,1,3,"AL WARQA'A SECOND",الورقاء الثانية
2006,6537,0,3,"AL WARQA'A SECOND",الورقاء الثانية
2007,6537,4,7,"AL WARQA'A SECOND",الورقاء الثانية
2008,6537,0,7,"AL WARQA'A SECOND",الورقاء الثانية
2009,6537,3,10,"AL WARQA'A SECOND",الورقاء الثانية
2010,6537,5,15,"AL WARQA'A SECOND",الورقاء الثانية
2011,6537,1,16,"AL WARQA'A SECOND",الورقاء الثانية
2012,6537,1,17,"AL WARQA'A SECOND",الورقاء الثانية
2013,6537,2,19,"AL WARQA'A SECOND",الورقاء الثانية
2014,6537,8,27,"AL WARQA'A SECOND",الورقاء الثانية
2015,6537,4,31,"AL WARQA'A SECOND",الورقاء الثانية
2016,6537,1,32,"AL WARQA'A SECOND",الورقاء الثانية
2017,6537,4,36,"AL WARQA'A SECOND",الورقاء الثانية
2018,6537,7,43,"AL WARQA'A SECOND",الورقاء الثانية
2019,6537,14,57,"AL WARQA'A SECOND",الورقاء الثانية
2020,6537,75,132,"AL WARQA'A SECOND",الورقاء الثانية
2021,6537,0,132,"AL WARQA'A SECOND",الورقاء الثانية
1963,6577,1,1,AL QUSAIS IND. SECOND,القصيص الصناعية الثانية
1964,6577,0,1,AL QUSAIS IND. SECOND,القصيص الصناعية الثانية
1965,6577,1,2,AL QUSAIS IND. SECOND,القصيص الصناعية الثانية
1966,6577,0,2,AL QUSAIS IND. SECOND,القصيص الصناعية الثانية
1967,6577,0,2,AL QUSAIS IND. SECOND,القصيص الصناعية الثانية
1968,6577,0,2,AL QUSAIS IND. SECOND,القصيص الصناعية الثانية
1969,6577,0,2,AL QUSAIS IND. SECOND,القصيص الصناعية الثانية
1970,6577,0,2,AL QUSAIS IND. SECOND,القصيص الصناعية الثانية
1971,6577,1,3,AL QUSAIS IND. SECOND,القصيص الصناعية الثانية
1972,6577,1,4,AL QUSAIS IND. SECOND,القصيص الصناعية الثانية
1973,6577,0,4,AL QUSAIS IND. SECOND,القصيص الصناعية الثانية
1974,6577,0,4,AL QUSAIS IND. SECOND,القصيص الصناعية الثانية
1975,6577,7,11,AL QUSAIS IND. SECOND,القصيص الصناعية الثانية
1976,6577,4,15,AL QUSAIS IND. SECOND,القصيص الصناعية الثانية
1977,6577,1,16,AL QUSAIS IND. SECOND,القصيص الصناعية الثانية
1978,6577,1,17,AL QUSAIS IND. SECOND,القصيص الصناعية الثانية
1979,6577,4,21,AL QUSAIS IND. SECOND,القصيص الصناعية الثانية
1980,6577,7,28,AL QUSAIS IND. SECOND,القصيص الصناعية الثانية
1981,6577,2,30,AL QUSAIS IND. SECOND,القصيص الصناعية الثانية
1982,6577,2,32,AL QUSAIS IND. SECOND,القصيص الصناعية الثانية
1983,6577,3,35,AL QUSAIS IND. SECOND,القصيص الصناعية الثانية
1984,6577,1,36,AL QUSAIS IND. SECOND,القصيص الصناعية الثانية
1985,6577,3,39,AL QUSAIS IND. SECOND,القصيص الصناعية الثانية
1986,6577,1,40,AL QUSAIS IND. SECOND,القصيص الصناعية الثانية
1987,6577,3,43,AL QUSAIS IND. SECOND,القصيص الصناعية الثانية
1988,6577,5,48,AL QUSAIS IND. SECOND,القصيص الصناعية الثانية
1989,6577,1,49,AL QUSAIS IND. SECOND,القصيص الصناعية الثانية
1990,6577,0,49,AL QUSAIS IND. SECOND,القصيص الصناعية الثانية
1991,6577,1,50,AL QUSAIS IND. SECOND,القصيص الصناعية الثانية
1992,6577,6,56,AL QUSAIS IND. SECOND,القصيص الصناعية الثانية
1993,6577,5,61,AL QUSAIS IND. SECOND,القصيص الصناعية الثانية
1994,6577,10,71,AL QUSAIS IND. SECOND,القصيص الصناعية الثانية
1995,6577,4,75,AL QUSAIS IND. SECOND,القصيص الصناعية الثانية
1996,6577,14,89,AL QUSAIS IND. SECOND,القصيص الصناعية الثانية
1997,6577,9,98,AL QUSAIS IND. SECOND,القصيص الصناعية الثانية
1998,6577,12,110,AL QUSAIS IND. SECOND,القصيص الصناعية الثانية
1999,6577,8,118,AL QUSAIS IND. SECOND,القصيص الصناعية الثانية
2000,6577,15,133,AL QUSAIS IND. SECOND,القصيص الصناعية الثانية
2001,6577,14,147,AL QUSAIS IND. SECOND,القصيص الصناعية الثانية
2002,6577,20,167,AL QUSAIS IND. SECOND,القصيص الصناعية الثانية
2003,6577,22,189,AL QUSAIS IND. SECOND,القصيص الصناعية الثانية
2004,6577,41,230,AL QUSAIS IND. SECOND,القصيص الصناعية الثانية
2005,6577,31,261,AL QUSAIS IND. SECOND,القصيص الصناعية الثانية
2006,6577,29,290,AL QUSAIS IND. SECOND,القصيص الصناعية الثانية
2007,6577,26,316,AL QUSAIS IND. SECOND,القصيص الصناعية الثانية
2008,6577,34,350,AL QUSAIS IND. SECOND,القصيص الصناعية الثانية
2009,6577,21,371,AL QUSAIS IND. SECOND,القصيص الصناعية الثانية
2010,6577,20,391,AL QUSAIS IND. SECOND,القصيص الصناعية الثانية
2011,6577,31,422,AL QUSAIS IND. SECOND,القصيص الصناعية الثانية
2012,6577,36,458,AL QUSAIS IND. SECOND,القصيص الصناعية الثانية
2013,6577,50,508,AL QUSAIS IND. SECOND,القصيص الصناعية الثانية
2014,6577,37,545,AL QUSAIS IND. SECOND,القصيص الصناعية الثانية
2015,6577,62,607,AL QUSAIS IND. SECOND,القصيص الصناعية الثانية
2016,6577,51,658,AL QUSAIS IND. SECOND,القصيص الصناعية الثانية
2017,6577,58,716,AL QUSAIS IND. SECOND,القصيص الصناعية الثانية
2018,6577,43,759,AL QUSAIS IND. SECOND,القصيص الصناعية الثانية
2019,6577,59,818,AL QUSAIS IND. SECOND,القصيص الصناعية الثانية
2020,6577,75,893,AL QUSAIS IND. SECOND,القصيص الصناعية الثانية
2021,6577,0,893,AL QUSAIS IND. SECOND,القصيص الصناعية الثانية
1963,6657,0,0,OUD AL MUTEENA FIRST,عود المطينة الأولى
1964,6657,0,0,OUD AL MUTEENA FIRST,عود المطينة الأولى
1965,6657,0,0,OUD AL MUTEENA FIRST,عود المطينة الأولى
1966,6657,0,0,OUD AL MUTEENA FIRST,عود المطينة الأولى
1967,6657,0,0,OUD AL MUTEENA FIRST,عود المطينة الأولى
1968,6657,0,0,OUD AL MUTEENA FIRST,عود المطينة الأولى
1969,6657,0,0,OUD AL MUTEENA FIRST,عود المطينة الأولى
1970,6657,0,0,OUD AL MUTEENA FIRST,عود المطينة الأولى
1971,6657,0,0,OUD AL MUTEENA FIRST,عود المطينة الأولى
1972,6657,0,0,OUD AL MUTEENA FIRST,عود المطينة الأولى
1973,6657,0,0,OUD AL MUTEENA FIRST,عود المطينة الأولى
1974,6657,0,0,OUD AL MUTEENA FIRST,عود المطينة الأولى
1975,6657,0,0,OUD AL MUTEENA FIRST,عود المطينة الأولى
1976,6657,0,0,OUD AL MUTEENA FIRST,عود المطينة الأولى
1977,6657,1,1,OUD AL MUTEENA FIRST,عود المطينة الأولى
1978,6657,0,1,OUD AL MUTEENA FIRST,عود المطينة الأولى
1979,6657,0,1,OUD AL MUTEENA FIRST,عود المطينة الأولى
1980,6657,0,1,OUD AL MUTEENA FIRST,عود المطينة الأولى
1981,6657,0,1,OUD AL MUTEENA FIRST,عود المطينة الأولى
1982,6657,0,1,OUD AL MUTEENA FIRST,عود المطينة الأولى
1983,6657,0,1,OUD AL MUTEENA FIRST,عود المطينة الأولى
1984,6657,0,1,OUD AL MUTEENA FIRST,عود المطينة الأولى
1985,6657,0,1,OUD AL MUTEENA FIRST,عود المطينة الأولى
1986,6657,0,1,OUD AL MUTEENA FIRST,عود المطينة الأولى
1987,6657,0,1,OUD AL MUTEENA FIRST,عود المطينة الأولى
1988,6657,0,1,OUD AL MUTEENA FIRST,عود المطينة الأولى
1989,6657,0,1,OUD AL MUTEENA FIRST,عود المطينة الأولى
1990,6657,0,1,OUD AL MUTEENA FIRST,عود المطينة الأولى
1991,6657,0,1,OUD AL MUTEENA FIRST,عود المطينة الأولى
1992,6657,1,2,OUD AL MUTEENA FIRST,عود المطينة الأولى
1993,6657,0,2,OUD AL MUTEENA FIRST,عود المطينة الأولى
1994,6657,0,2,OUD AL MUTEENA FIRST,عود المطينة الأولى
1995,6657,0,2,OUD AL MUTEENA FIRST,عود المطينة الأولى
1996,6657,0,2,OUD AL MUTEENA FIRST,عود المطينة الأولى
1997,6657,0,2,OUD AL MUTEENA FIRST,عود المطينة الأولى
1998,6657,2,4,OUD AL MUTEENA FIRST,عود المطينة الأولى
1999,6657,0,4,OUD AL MUTEENA FIRST,عود المطينة الأولى
2000,6657,0,4,OUD AL MUTEENA FIRST,عود المطينة الأولى
2001,6657,0,4,OUD AL MUTEENA FIRST,عود المطينة الأولى
2002,6657,0,4,OUD AL MUTEENA FIRST,عود المطينة الأولى
2003,6657,0,4,OUD AL MUTEENA FIRST,عود المطينة الأولى
2004,6657,0,4,OUD AL MUTEENA FIRST,عود المطينة الأولى
2005,6657,2,6,OUD AL MUTEENA FIRST,عود المطينة الأولى
2006,6657,1,7,OUD AL MUTEENA FIRST,عود المطينة الأولى
2007,6657,2,9,OUD AL MUTEENA FIRST,عود المطينة الأولى
2008,6657,1,10,OUD AL MUTEENA FIRST,عود المطينة الأولى
2009,6657,0,10,OUD AL MUTEENA FIRST,عود المطينة الأولى
2010,6657,5,15,OUD AL MUTEENA FIRST,عود المطينة الأولى
2011,6657,5,20,OUD AL MUTEENA FIRST,عود المطينة الأولى
2012,6657,1,21,OUD AL MUTEENA FIRST,عود المطينة الأولى
2013,6657,5,26,OUD AL MUTEENA FIRST,عود المطينة الأولى
2014,6657,6,32,OUD AL MUTEENA FIRST,عود المطينة الأولى
2015,6657,4,36,OUD AL MUTEENA FIRST,عود المطينة الأولى
2016,6657,3,39,OUD AL MUTEENA FIRST,عود المطينة الأولى
2017,6657,9,48,OUD AL MUTEENA FIRST,عود المطينة الأولى
2018,6657,12,60,OUD AL MUTEENA FIRST,عود المطينة الأولى
2019,6657,15,75,OUD AL MUTEENA FIRST,عود المطينة الأولى
2020,6657,77,152,OUD AL MUTEENA FIRST,عود المطينة الأولى
2021,6657,0,152,OUD AL MUTEENA FIRST,عود المطينة الأولى
1963,6697,0,0,WADI AL SAFA 5,وادي الصفا 5
1964,6697,0,0,WADI AL SAFA 5,وادي الصفا 5
1965,6697,0,0,WADI AL SAFA 5,وادي الصفا 5
1966,6697,0,0,WADI AL SAFA 5,وادي الصفا 5
1967,6697,0,0,WADI AL SAFA 5,وادي الصفا 5
1968,6697,0,0,WADI AL SAFA 5,وادي الصفا 5
1969,6697,0,0,WADI AL SAFA 5,وادي الصفا 5
1970,6697,0,0,WADI AL SAFA 5,وادي الصفا 5
1971,6697,0,0,WADI AL SAFA 5,وادي الصفا 5
1972,6697,0,0,WADI AL SAFA 5,وادي الصفا 5
1973,6697,0,0,WADI AL SAFA 5,وادي الصفا 5
1974,6697,0,0,WADI AL SAFA 5,وادي الصفا 5
1975,6697,0,0,WADI AL SAFA 5,وادي الصفا 5
1976,6697,0,0,WADI AL SAFA 5,وادي الصفا 5
1977,6697,0,0,WADI AL SAFA 5,وادي الصفا 5
1978,6697,0,0,WADI AL SAFA 5,وادي الصفا 5
1979,6697,0,0,WADI AL SAFA 5,وادي الصفا 5
1980,6697,0,0,WADI AL SAFA 5,وادي الصفا 5
1981,6697,0,0,WADI AL SAFA 5,وادي الصفا 5
1982,6697,0,0,WADI AL SAFA 5,وادي الصفا 5
1983,6697,0,0,WADI AL SAFA 5,وادي الصفا 5
1984,6697,0,0,WADI AL SAFA 5,وادي الصفا 5
1985,6697,0,0,WADI AL SAFA 5,وادي الصفا 5
1986,6697,0,0,WADI AL SAFA 5,وادي الصفا 5
1987,6697,0,0,WADI AL SAFA 5,وادي الصفا 5
1988,6697,0,0,WADI AL SAFA 5,وادي الصفا 5
1989,6697,0,0,WADI AL SAFA 5,وادي الصفا 5
1990,6697,0,0,WADI AL SAFA 5,وادي الصفا 5
1991,6697,0,0,WADI AL SAFA 5,وادي الصفا 5
1992,6697,1,1,WADI AL SAFA 5,وادي الصفا 5
1993,6697,0,1,WADI AL SAFA 5,وادي الصفا 5
1994,6697,0,1,WADI AL SAFA 5,وادي الصفا 5
1995,6697,0,1,WADI AL SAFA 5,وادي الصفا 5
1996,6697,0,1,WADI AL SAFA 5,وادي الصفا 5
1997,6697,0,1,WADI AL SAFA 5,وادي الصفا 5
1998,6697,0,1,WADI AL SAFA 5,وادي الصفا 5
1999,6697,0,1,WADI AL SAFA 5,وادي الصفا 5
2000,6697,0,1,WADI AL SAFA 5,وادي الصفا 5
2001,6697,1,2,WADI AL SAFA 5,وادي الصفا 5
2002,6697,0,2,WADI AL SAFA 5,وادي الصفا 5
2003,6697,0,2,WADI AL SAFA 5,وادي الصفا 5
2004,6697,0,2,WADI AL SAFA 5,وادي الصفا 5
2005,6697,0,2,WADI AL SAFA 5,وادي الصفا 5
2006,6697,0,2,WADI AL SAFA 5,وادي الصفا 5
2007,6697,1,3,WADI AL SAFA 5,وادي الصفا 5
2008,6697,0,3,WADI AL SAFA 5,وادي الصفا 5
2009,6697,0,3,WADI AL SAFA 5,وادي الصفا 5
2010,6697,0,3,WADI AL SAFA 5,وادي الصفا 5
2011,6697,0,3,WADI AL SAFA 5,وادي الصفا 5
2012,6697,1,4,WADI AL SAFA 5,وادي الصفا 5
2013,6697,3,7,WADI AL SAFA 5,وادي الصفا 5
2014,6697,4,11,WADI AL SAFA 5,وادي الصفا 5
2015,6697,8,19,WADI AL SAFA 5,وادي الصفا 5
2016,6697,5,24,WADI AL SAFA 5,وادي الصفا 5
2017,6697,1,25,WADI AL SAFA 5,وادي الصفا 5
2018,6697,13,38,WADI AL SAFA 5,وادي الصفا 5
2019,6697,32,70,WADI AL SAFA 5,وادي الصفا 5
2020,6697,31,101,WADI AL SAFA 5,وادي الصفا 5
2021,6697,0,101,WADI AL SAFA 5,وادي الصفا 5
1963,6777,0,0,JUMEIRA THIRD,جميرا الثالثة
1964,6777,0,0,JUMEIRA THIRD,جميرا الثالثة
1965,6777,0,0,JUMEIRA THIRD,جميرا الثالثة
1966,6777,0,0,JUMEIRA THIRD,جميرا الثالثة
1967,6777,0,0,JUMEIRA THIRD,جميرا الثالثة
1968,6777,0,0,JUMEIRA THIRD,جميرا الثالثة
1969,6777,0,0,JUMEIRA THIRD,جميرا الثالثة
1970,6777,0,0,JUMEIRA THIRD,جميرا الثالثة
1971,6777,0,0,JUMEIRA THIRD,جميرا الثالثة
1972,6777,0,0,JUMEIRA THIRD,جميرا الثالثة
1973,6777,0,0,JUMEIRA THIRD,جميرا الثالثة
1974,6777,0,0,JUMEIRA THIRD,جميرا الثالثة
1975,6777,0,0,JUMEIRA THIRD,جميرا الثالثة
1976,6777,0,0,JUMEIRA THIRD,جميرا الثالثة
1977,6777,0,0,JUMEIRA THIRD,جميرا الثالثة
1978,6777,0,0,JUMEIRA THIRD,جميرا الثالثة
1979,6777,0,0,JUMEIRA THIRD,جميرا الثالثة
1980,6777,0,0,JUMEIRA THIRD,جميرا الثالثة
1981,6777,3,3,JUMEIRA THIRD,جميرا الثالثة
1982,6777,0,3,JUMEIRA THIRD,جميرا الثالثة
1983,6777,1,4,JUMEIRA THIRD,جميرا الثالثة
1984,6777,1,5,JUMEIRA THIRD,جميرا الثالثة
1985,6777,1,6,JUMEIRA THIRD,جميرا الثالثة
1986,6777,0,6,JUMEIRA THIRD,جميرا الثالثة
1987,6777,0,6,JUMEIRA THIRD,جميرا الثالثة
1988,6777,0,6,JUMEIRA THIRD,جميرا الثالثة
1989,6777,2,8,JUMEIRA THIRD,جميرا الثالثة
1990,6777,1,9,JUMEIRA THIRD,جميرا الثالثة
1991,6777,1,10,JUMEIRA THIRD,جميرا الثالثة
1992,6777,0,10,JUMEIRA THIRD,جميرا الثالثة
1993,6777,0,10,JUMEIRA THIRD,جميرا الثالثة
1994,6777,0,10,JUMEIRA THIRD,جميرا الثالثة
1995,6777,0,10,JUMEIRA THIRD,جميرا الثالثة
1996,6777,1,11,JUMEIRA THIRD,جميرا الثالثة
1997,6777,2,13,JUMEIRA THIRD,جميرا الثالثة
1998,6777,4,17,JUMEIRA THIRD,جميرا الثالثة
1999,6777,5,22,JUMEIRA THIRD,جميرا الثالثة
2000,6777,0,22,JUMEIRA THIRD,جميرا الثالثة
2001,6777,5,27,JUMEIRA THIRD,جميرا الثالثة
2002,6777,2,29,JUMEIRA THIRD,جميرا الثالثة
2003,6777,0,29,JUMEIRA THIRD,جميرا الثالثة
2004,6777,4,33,JUMEIRA THIRD,جميرا الثالثة
2005,6777,3,36,JUMEIRA THIRD,جميرا الثالثة
2006,6777,5,41,JUMEIRA THIRD,جميرا الثالثة
2007,6777,5,46,JUMEIRA THIRD,جميرا الثالثة
2008,6777,10,56,JUMEIRA THIRD,جميرا الثالثة
2009,6777,4,60,JUMEIRA THIRD,جميرا الثالثة
2010,6777,12,72,JUMEIRA THIRD,جميرا الثالثة
2011,6777,8,80,JUMEIRA THIRD,جميرا الثالثة
2012,6777,18,98,JUMEIRA THIRD,جميرا الثالثة
2013,6777,10,108,JUMEIRA THIRD,جميرا الثالثة
2014,6777,18,126,JUMEIRA THIRD,جميرا الثالثة
2015,6777,16,142,JUMEIRA THIRD,جميرا الثالثة
2016,6777,15,157,JUMEIRA THIRD,جميرا الثالثة
2017,6777,29,186,JUMEIRA THIRD,جميرا الثالثة
2018,6777,42,228,JUMEIRA THIRD,جميرا الثالثة
2019,6777,70,298,JUMEIRA THIRD,جميرا الثالثة
2020,6777,112,410,JUMEIRA THIRD,جميرا الثالثة
2021,6777,0,410,JUMEIRA THIRD,جميرا الثالثة
1963,6857,0,0,WARSAN SECOND,ورسان الثانية
1964,6857,0,0,WARSAN SECOND,ورسان الثانية
1965,6857,0,0,WARSAN SECOND,ورسان الثانية
1966,6857,0,0,WARSAN SECOND,ورسان الثانية
1967,6857,0,0,WARSAN SECOND,ورسان الثانية
1968,6857,0,0,WARSAN SECOND,ورسان الثانية
1969,6857,0,0,WARSAN SECOND,ورسان الثانية
1970,6857,0,0,WARSAN SECOND,ورسان الثانية
1971,6857,0,0,WARSAN SECOND,ورسان الثانية
1972,6857,1,1,WARSAN SECOND,ورسان الثانية
1973,6857,0,1,WARSAN SECOND,ورسان الثانية
1974,6857,0,1,WARSAN SECOND,ورسان الثانية
1975,6857,0,1,WARSAN SECOND,ورسان الثانية
1976,6857,0,1,WARSAN SECOND,ورسان الثانية
1977,6857,0,1,WARSAN SECOND,ورسان الثانية
1978,6857,0,1,WARSAN SECOND,ورسان الثانية
1979,6857,1,2,WARSAN SECOND,ورسان الثانية
1980,6857,0,2,WARSAN SECOND,ورسان الثانية
1981,6857,1,3,WARSAN SECOND,ورسان الثانية
1982,6857,0,3,WARSAN SECOND,ورسان الثانية
1983,6857,1,4,WARSAN SECOND,ورسان الثانية
1984,6857,3,7,WARSAN SECOND,ورسان الثانية
1985,6857,0,7,WARSAN SECOND,ورسان الثانية
1986,6857,2,9,WARSAN SECOND,ورسان الثانية
1987,6857,1,10,WARSAN SECOND,ورسان الثانية
1988,6857,4,14,WARSAN SECOND,ورسان الثانية
1989,6857,1,15,WARSAN SECOND,ورسان الثانية
1990,6857,0,15,WARSAN SECOND,ورسان الثانية
1991,6857,1,16,WARSAN SECOND,ورسان الثانية
1992,6857,1,17,WARSAN SECOND,ورسان الثانية
1993,6857,4,21,WARSAN SECOND,ورسان الثانية
1994,6857,2,23,WARSAN SECOND,ورسان الثانية
1995,6857,1,24,WARSAN SECOND,ورسان الثانية
1996,6857,0,24,WARSAN SECOND,ورسان الثانية
1997,6857,6,30,WARSAN SECOND,ورسان الثانية
1998,6857,2,32,WARSAN SECOND,ورسان الثانية
1999,6857,5,37,WARSAN SECOND,ورسان الثانية
2000,6857,4,41,WARSAN SECOND,ورسان الثانية
2001,6857,3,44,WARSAN SECOND,ورسان الثانية
2002,6857,3,47,WARSAN SECOND,ورسان الثانية
2003,6857,8,55,WARSAN SECOND,ورسان الثانية
2004,6857,9,64,WARSAN SECOND,ورسان الثانية
2005,6857,4,68,WARSAN SECOND,ورسان الثانية
2006,6857,8,76,WARSAN SECOND,ورسان الثانية
2007,6857,11,87,WARSAN SECOND,ورسان الثانية
2008,6857,10,97,WARSAN SECOND,ورسان الثانية
2009,6857,5,102,WARSAN SECOND,ورسان الثانية
2010,6857,13,115,WARSAN SECOND,ورسان الثانية
2011,6857,6,121,WARSAN SECOND,ورسان الثانية
2012,6857,16,137,WARSAN SECOND,ورسان الثانية
2013,6857,36,173,WARSAN SECOND,ورسان الثانية
2014,6857,18,191,WARSAN SECOND,ورسان الثانية
2015,6857,49,240,WARSAN SECOND,ورسان الثانية
2016,6857,39,279,WARSAN SECOND,ورسان الثانية
2017,6857,37,316,WARSAN SECOND,ورسان الثانية
2018,6857,49,365,WARSAN SECOND,ورسان الثانية
2019,6857,58,423,WARSAN SECOND,ورسان الثانية
2020,6857,96,519,WARSAN SECOND,ورسان الثانية
2021,6857,0,519,WARSAN SECOND,ورسان الثانية
1963,6897,0,0,AL QUSAIS IND. FIRST,القصيص الصناعية الأولى
1964,6897,0,0,AL QUSAIS IND. FIRST,القصيص الصناعية الأولى
1965,6897,1,1,AL QUSAIS IND. FIRST,القصيص الصناعية الأولى
1966,6897,0,1,AL QUSAIS IND. FIRST,القصيص الصناعية الأولى
1967,6897,1,2,AL QUSAIS IND. FIRST,القصيص الصناعية الأولى
1968,6897,0,2,AL QUSAIS IND. FIRST,القصيص الصناعية الأولى
1969,6897,0,2,AL QUSAIS IND. FIRST,القصيص الصناعية الأولى
1970,6897,0,2,AL QUSAIS IND. FIRST,القصيص الصناعية الأولى
1971,6897,2,4,AL QUSAIS IND. FIRST,القصيص الصناعية الأولى
1972,6897,0,4,AL QUSAIS IND. FIRST,القصيص الصناعية الأولى
1973,6897,0,4,AL QUSAIS IND. FIRST,القصيص الصناعية الأولى
1974,6897,0,4,AL QUSAIS IND. FIRST,القصيص الصناعية الأولى
1975,6897,1,5,AL QUSAIS IND. FIRST,القصيص الصناعية الأولى
1976,6897,0,5,AL QUSAIS IND. FIRST,القصيص الصناعية الأولى
1977,6897,1,6,AL QUSAIS IND. FIRST,القصيص الصناعية الأولى
1978,6897,2,8,AL QUSAIS IND. FIRST,القصيص الصناعية الأولى
1979,6897,2,10,AL QUSAIS IND. FIRST,القصيص الصناعية الأولى
1980,6897,0,10,AL QUSAIS IND. FIRST,القصيص الصناعية الأولى
1981,6897,2,12,AL QUSAIS IND. FIRST,القصيص الصناعية الأولى
1982,6897,1,13,AL QUSAIS IND. FIRST,القصيص الصناعية الأولى
1983,6897,2,15,AL QUSAIS IND. FIRST,القصيص الصناعية الأولى
1984,6897,1,16,AL QUSAIS IND. FIRST,القصيص الصناعية الأولى
1985,6897,3,19,AL QUSAIS IND. FIRST,القصيص الصناعية الأولى
1986,6897,0,19,AL QUSAIS IND. FIRST,القصيص الصناعية الأولى
1987,6897,1,20,AL QUSAIS IND. FIRST,القصيص الصناعية الأولى
1988,6897,4,24,AL QUSAIS IND. FIRST,القصيص الصناعية الأولى
1989,6897,3,27,AL QUSAIS IND. FIRST,القصيص الصناعية الأولى
1990,6897,8,35,AL QUSAIS IND. FIRST,القصيص الصناعية الأولى
1991,6897,2,37,AL QUSAIS IND. FIRST,القصيص الصناعية الأولى
1992,6897,6,43,AL QUSAIS IND. FIRST,القصيص الصناعية الأولى
1993,6897,4,47,AL QUSAIS IND. FIRST,القصيص الصناعية الأولى
1994,6897,7,54,AL QUSAIS IND. FIRST,القصيص الصناعية الأولى
1995,6897,5,59,AL QUSAIS IND. FIRST,القصيص الصناعية الأولى
1996,6897,5,64,AL QUSAIS IND. FIRST,القصيص الصناعية الأولى
1997,6897,9,73,AL QUSAIS IND. FIRST,القصيص الصناعية الأولى
1998,6897,6,79,AL QUSAIS IND. FIRST,القصيص الصناعية الأولى
1999,6897,5,84,AL QUSAIS IND. FIRST,القصيص الصناعية الأولى
2000,6897,6,90,AL QUSAIS IND. FIRST,القصيص الصناعية الأولى
2001,6897,14,104,AL QUSAIS IND. FIRST,القصيص الصناعية الأولى
2002,6897,10,114,AL QUSAIS IND. FIRST,القصيص الصناعية الأولى
2003,6897,13,127,AL QUSAIS IND. FIRST,القصيص الصناعية الأولى
2004,6897,15,142,AL QUSAIS IND. FIRST,القصيص الصناعية الأولى
2005,6897,23,165,AL QUSAIS IND. FIRST,القصيص الصناعية الأولى
2006,6897,15,180,AL QUSAIS IND. FIRST,القصيص الصناعية الأولى
2007,6897,22,202,AL QUSAIS IND. FIRST,القصيص الصناعية الأولى
2008,6897,20,222,AL QUSAIS IND. FIRST,القصيص الصناعية الأولى
2009,6897,15,237,AL QUSAIS IND. FIRST,القصيص الصناعية الأولى
2010,6897,19,256,AL QUSAIS IND. FIRST,القصيص الصناعية الأولى
2011,6897,25,281,AL QUSAIS IND. FIRST,القصيص الصناعية الأولى
2012,6897,35,316,AL QUSAIS IND. FIRST,القصيص الصناعية الأولى
2013,6897,34,350,AL QUSAIS IND. FIRST,القصيص الصناعية الأولى
2014,6897,48,398,AL QUSAIS IND. FIRST,القصيص الصناعية الأولى
2015,6897,37,435,AL QUSAIS IND. FIRST,القصيص الصناعية الأولى
2016,6897,45,480,AL QUSAIS IND. FIRST,القصيص الصناعية الأولى
2017,6897,46,526,AL QUSAIS IND. FIRST,القصيص الصناعية الأولى
2018,6897,48,574,AL QUSAIS IND. FIRST,القصيص الصناعية الأولى
2019,6897,55,629,AL QUSAIS IND. FIRST,القصيص الصناعية الأولى
2020,6897,114,743,AL QUSAIS IND. FIRST,القصيص الصناعية الأولى
2021,6897,0,743,AL QUSAIS IND. FIRST,القصيص الصناعية الأولى
1963,6937,0,0,AL SAFOUH SECOND,الصفوح الثانية
1964,6937,1,1,AL SAFOUH SECOND,الصفوح الثانية
1965,6937,0,1,AL SAFOUH SECOND,الصفوح الثانية
1966,6937,0,1,AL SAFOUH SECOND,الصفوح الثانية
1967,6937,0,1,AL SAFOUH SECOND,الصفوح الثانية
1968,6937,0,1,AL SAFOUH SECOND,الصفوح الثانية
1969,6937,0,1,AL SAFOUH SECOND,الصفوح الثانية
1970,6937,1,2,AL SAFOUH SECOND,الصفوح الثانية
1971,6937,2,4,AL SAFOUH SECOND,الصفوح الثانية
1972,6937,0,4,AL SAFOUH SECOND,الصفوح الثانية
1973,6937,2,6,AL SAFOUH SECOND,الصفوح الثانية
1974,6937,0,6,AL SAFOUH SECOND,الصفوح الثانية
1975,6937,0,6,AL SAFOUH SECOND,الصفوح الثانية
1976,6937,7,13,AL SAFOUH SECOND,الصفوح الثانية
1977,6937,0,13,AL SAFOUH SECOND,الصفوح الثانية
1978,6937,1,14,AL SAFOUH SECOND,الصفوح الثانية
1979,6937,1,15,AL SAFOUH SECOND,الصفوح الثانية
1980,6937,3,18,AL SAFOUH SECOND,الصفوح الثانية
1981,6937,3,21,AL SAFOUH SECOND,الصفوح الثانية
1982,6937,3,24,AL SAFOUH SECOND,الصفوح الثانية
1983,6937,0,24,AL SAFOUH SECOND,الصفوح الثانية
1984,6937,4,28,AL SAFOUH SECOND,الصفوح الثانية
1985,6937,0,28,AL SAFOUH SECOND,الصفوح الثانية
1986,6937,0,28,AL SAFOUH SECOND,الصفوح الثانية
1987,6937,1,29,AL SAFOUH SECOND,الصفوح الثانية
1988,6937,2,31,AL SAFOUH SECOND,الصفوح الثانية
1989,6937,1,32,AL SAFOUH SECOND,الصفوح الثانية
1990,6937,1,33,AL SAFOUH SECOND,الصفوح الثانية
1991,6937,3,36,AL SAFOUH SECOND,الصفوح الثانية
1992,6937,4,40,AL SAFOUH SECOND,الصفوح الثانية
1993,6937,2,42,AL SAFOUH SECOND,الصفوح الثانية
1994,6937,4,46,AL SAFOUH SECOND,الصفوح الثانية
1995,6937,6,52,AL SAFOUH SECOND,الصفوح الثانية
1996,6937,4,56,AL SAFOUH SECOND,الصفوح الثانية
1997,6937,11,67,AL SAFOUH SECOND,الصفوح الثانية
1998,6937,10,77,AL SAFOUH SECOND,الصفوح الثانية
1999,6937,5,82,AL SAFOUH SECOND,الصفوح الثانية
2000,6937,9,91,AL SAFOUH SECOND,الصفوح الثانية
2001,6937,9,100,AL SAFOUH SECOND,الصفوح الثانية
2002,6937,7,107,AL SAFOUH SECOND,الصفوح الثانية
2003,6937,16,123,AL SAFOUH SECOND,الصفوح الثانية
2004,6937,23,146,AL SAFOUH SECOND,الصفوح الثانية
2005,6937,19,165,AL SAFOUH SECOND,الصفوح الثانية
2006,6937,26,191,AL SAFOUH SECOND,الصفوح الثانية
2007,6937,37,228,AL SAFOUH SECOND,الصفوح الثانية
2008,6937,29,257,AL SAFOUH SECOND,الصفوح الثانية
2009,6937,24,281,AL SAFOUH SECOND,الصفوح الثانية
2010,6937,39,320,AL SAFOUH SECOND,الصفوح الثانية
2011,6937,42,362,AL SAFOUH SECOND,الصفوح الثانية
2012,6937,44,406,AL SAFOUH SECOND,الصفوح الثانية
2013,6937,58,464,AL SAFOUH SECOND,الصفوح الثانية
2014,6937,72,536,AL SAFOUH SECOND,الصفوح الثانية
2015,6937,54,590,AL SAFOUH SECOND,الصفوح الثانية
2016,6937,47,637,AL SAFOUH SECOND,الصفوح الثانية
2017,6937,49,686,AL SAFOUH SECOND,الصفوح الثانية
2018,6937,42,728,AL SAFOUH SECOND,الصفوح الثانية
2019,6937,55,783,AL SAFOUH SECOND,الصفوح الثانية
2020,6937,54,837,AL SAFOUH SECOND,الصفوح الثانية
2021,6937,0,837,AL SAFOUH SECOND,الصفوح الثانية
1963,6977,0,0,TRADE CENTER SECOND,المركز التجاري الثانية
1964,6977,0,0,TRADE CENTER SECOND,المركز التجاري الثانية
1965,6977,0,0,TRADE CENTER SECOND,المركز التجاري الثانية
1966,6977,0,0,TRADE CENTER SECOND,المركز التجاري الثانية
1967,6977,0,0,TRADE CENTER SECOND,المركز التجاري الثانية
1968,6977,0,0,TRADE CENTER SECOND,المركز التجاري الثانية
1969,6977,0,0,TRADE CENTER SECOND,المركز التجاري الثانية
1970,6977,1,1,TRADE CENTER SECOND,المركز التجاري الثانية
1971,6977,1,2,TRADE CENTER SECOND,المركز التجاري الثانية
1972,6977,0,2,TRADE CENTER SECOND,المركز التجاري الثانية
1973,6977,1,3,TRADE CENTER SECOND,المركز التجاري الثانية
1974,6977,0,3,TRADE CENTER SECOND,المركز التجاري الثانية
1975,6977,1,4,TRADE CENTER SECOND,المركز التجاري الثانية
1976,6977,0,4,TRADE CENTER SECOND,المركز التجاري الثانية
1977,6977,0,4,TRADE CENTER SECOND,المركز التجاري الثانية
1978,6977,1,5,TRADE CENTER SECOND,المركز التجاري الثانية
1979,6977,1,6,TRADE CENTER SECOND,المركز التجاري الثانية
1980,6977,0,6,TRADE CENTER SECOND,المركز التجاري الثانية
1981,6977,1,7,TRADE CENTER SECOND,المركز التجاري الثانية
1982,6977,1,8,TRADE CENTER SECOND,المركز التجاري الثانية
1983,6977,2,10,TRADE CENTER SECOND,المركز التجاري الثانية
1984,6977,0,10,TRADE CENTER SECOND,المركز التجاري الثانية
1985,6977,0,10,TRADE CENTER SECOND,المركز التجاري الثانية
1986,6977,1,11,TRADE CENTER SECOND,المركز التجاري الثانية
1987,6977,0,11,TRADE CENTER SECOND,المركز التجاري الثانية
1988,6977,0,11,TRADE CENTER SECOND,المركز التجاري الثانية
1989,6977,2,13,TRADE CENTER SECOND,المركز التجاري الثانية
1990,6977,1,14,TRADE CENTER SECOND,المركز التجاري الثانية
1991,6977,1,15,TRADE CENTER SECOND,المركز التجاري الثانية
1992,6977,3,18,TRADE CENTER SECOND,المركز التجاري الثانية
1993,6977,3,21,TRADE CENTER SECOND,المركز التجاري الثانية
1994,6977,4,25,TRADE CENTER SECOND,المركز التجاري الثانية
1995,6977,5,30,TRADE CENTER SECOND,المركز التجاري الثانية
1996,6977,2,32,TRADE CENTER SECOND,المركز التجاري الثانية
1997,6977,2,34,TRADE CENTER SECOND,المركز التجاري الثانية
1998,6977,2,36,TRADE CENTER SECOND,المركز التجاري الثانية
1999,6977,1,37,TRADE CENTER SECOND,المركز التجاري الثانية
2000,6977,5,42,TRADE CENTER SECOND,المركز التجاري الثانية
2001,6977,5,47,TRADE CENTER SECOND,المركز التجاري الثانية
2002,6977,5,52,TRADE CENTER SECOND,المركز التجاري الثانية
2003,6977,13,65,TRADE CENTER SECOND,المركز التجاري الثانية
2004,6977,8,73,TRADE CENTER SECOND,المركز التجاري الثانية
2005,6977,16,89,TRADE CENTER SECOND,المركز التجاري الثانية
2006,6977,12,101,TRADE CENTER SECOND,المركز التجاري الثانية
2007,6977,17,118,TRADE CENTER SECOND,المركز التجاري الثانية
2008,6977,15,133,TRADE CENTER SECOND,المركز التجاري الثانية
2009,6977,7,140,TRADE CENTER SECOND,المركز التجاري الثانية
2010,6977,20,160,TRADE CENTER SECOND,المركز التجاري الثانية
2011,6977,16,176,TRADE CENTER SECOND,المركز التجاري الثانية
2012,6977,19,195,TRADE CENTER SECOND,المركز التجاري الثانية
2013,6977,20,215,TRADE CENTER SECOND,المركز التجاري الثانية
2014,6977,32,247,TRADE CENTER SECOND,المركز التجاري الثانية
2015,6977,25,272,TRADE CENTER SECOND,المركز التجاري الثانية
2016,6977,25,297,TRADE CENTER SECOND,المركز التجاري الثانية
2017,6977,21,318,TRADE CENTER SECOND,المركز التجاري الثانية
2018,6977,28,346,TRADE CENTER SECOND,المركز التجاري الثانية
2019,6977,44,390,TRADE CENTER SECOND,المركز التجاري الثانية
2020,6977,79,469,TRADE CENTER SECOND,المركز التجاري الثانية
2021,6977,0,469,TRADE CENTER SECOND,المركز التجاري الثانية
1963,7057,1,1,HOR AL ANZ EAST,هور العنز شرق
1964,7057,1,2,HOR AL ANZ EAST,هور العنز شرق
1965,7057,0,2,HOR AL ANZ EAST,هور العنز شرق
1966,7057,1,3,HOR AL ANZ EAST,هور العنز شرق
1967,7057,0,3,HOR AL ANZ EAST,هور العنز شرق
1968,7057,1,4,HOR AL ANZ EAST,هور العنز شرق
1969,7057,2,6,HOR AL ANZ EAST,هور العنز شرق
1970,7057,0,6,HOR AL ANZ EAST,هور العنز شرق
1971,7057,5,11,HOR AL ANZ EAST,هور العنز شرق
1972,7057,3,14,HOR AL ANZ EAST,هور العنز شرق
1973,7057,1,15,HOR AL ANZ EAST,هور العنز شرق
1974,7057,3,18,HOR AL ANZ EAST,هور العنز شرق
1975,7057,2,20,HOR AL ANZ EAST,هور العنز شرق
1976,7057,2,22,HOR AL ANZ EAST,هور العنز شرق
1977,7057,3,25,HOR AL ANZ EAST,هور العنز شرق
1978,7057,3,28,HOR AL ANZ EAST,هور العنز شرق
1979,7057,5,33,HOR AL ANZ EAST,هور العنز شرق
1980,7057,15,48,HOR AL ANZ EAST,هور العنز شرق
1981,7057,10,58,HOR AL ANZ EAST,هور العنز شرق
1982,7057,8,66,HOR AL ANZ EAST,هور العنز شرق
1983,7057,14,80,HOR AL ANZ EAST,هور العنز شرق
1984,7057,14,94,HOR AL ANZ EAST,هور العنز شرق
1985,7057,15,109,HOR AL ANZ EAST,هور العنز شرق
1986,7057,13,122,HOR AL ANZ EAST,هور العنز شرق
1987,7057,9,131,HOR AL ANZ EAST,هور العنز شرق
1988,7057,11,142,HOR AL ANZ EAST,هور العنز شرق
1989,7057,15,157,HOR AL ANZ EAST,هور العنز شرق
1990,7057,17,174,HOR AL ANZ EAST,هور العنز شرق
1991,7057,13,187,HOR AL ANZ EAST,هور العنز شرق
1992,7057,22,209,HOR AL ANZ EAST,هور العنز شرق
1993,7057,29,238,HOR AL ANZ EAST,هور العنز شرق
1994,7057,33,271,HOR AL ANZ EAST,هور العنز شرق
1995,7057,19,290,HOR AL ANZ EAST,هور العنز شرق
1996,7057,18,308,HOR AL ANZ EAST,هور العنز شرق
1997,7057,24,332,HOR AL ANZ EAST,هور العنز شرق
1998,7057,30,362,HOR AL ANZ EAST,هور العنز شرق
1999,7057,26,388,HOR AL ANZ EAST,هور العنز شرق
2000,7057,45,433,HOR AL ANZ EAST,هور العنز شرق
2001,7057,55,488,HOR AL ANZ EAST,هور العنز شرق
2002,7057,63,551,HOR AL ANZ EAST,هور العنز شرق
2003,7057,63,614,HOR AL ANZ EAST,هور العنز شرق
2004,7057,64,678,HOR AL ANZ EAST,هور العنز شرق
2005,7057,73,751,HOR AL ANZ EAST,هور العنز شرق
2006,7057,78,829,HOR AL ANZ EAST,هور العنز شرق
2007,7057,76,905,HOR AL ANZ EAST,هور العنز شرق
2008,7057,67,972,HOR AL ANZ EAST,هور العنز شرق
2009,7057,43,1015,HOR AL ANZ EAST,هور العنز شرق
2010,7057,88,1103,HOR AL ANZ EAST,هور العنز شرق
2011,7057,81,1184,HOR AL ANZ EAST,هور العنز شرق
2012,7057,111,1295,HOR AL ANZ EAST,هور العنز شرق
2013,7057,106,1401,HOR AL ANZ EAST,هور العنز شرق
2014,7057,135,1536,HOR AL ANZ EAST,هور العنز شرق
2015,7057,134,1670,HOR AL ANZ EAST,هور العنز شرق
2016,7057,139,1809,HOR AL ANZ EAST,هور العنز شرق
2017,7057,154,1963,HOR AL ANZ EAST,هور العنز شرق
2018,7057,151,2114,HOR AL ANZ EAST,هور العنز شرق
2019,7057,259,2373,HOR AL ANZ EAST,هور العنز شرق
2020,7057,395,2768,HOR AL ANZ EAST,هور العنز شرق
2021,7057,0,2768,HOR AL ANZ EAST,هور العنز شرق
1963,7097,0,0,"AL WARQA'A FIFTH",الورقاء الخامسة
1964,7097,0,0,"AL WARQA'A FIFTH",الورقاء الخامسة
1965,7097,0,0,"AL WARQA'A FIFTH",الورقاء الخامسة
1966,7097,0,0,"AL WARQA'A FIFTH",الورقاء الخامسة
1967,7097,0,0,"AL WARQA'A FIFTH",الورقاء الخامسة
1968,7097,0,0,"AL WARQA'A FIFTH",الورقاء الخامسة
1969,7097,0,0,"AL WARQA'A FIFTH",الورقاء الخامسة
1970,7097,0,0,"AL WARQA'A FIFTH",الورقاء الخامسة
1971,7097,0,0,"AL WARQA'A FIFTH",الورقاء الخامسة
1972,7097,0,0,"AL WARQA'A FIFTH",الورقاء الخامسة
1973,7097,0,0,"AL WARQA'A FIFTH",الورقاء الخامسة
1974,7097,0,0,"AL WARQA'A FIFTH",الورقاء الخامسة
1975,7097,1,1,"AL WARQA'A FIFTH",الورقاء الخامسة
1976,7097,1,2,"AL WARQA'A FIFTH",الورقاء الخامسة
1977,7097,1,3,"AL WARQA'A FIFTH",الورقاء الخامسة
1978,7097,0,3,"AL WARQA'A FIFTH",الورقاء الخامسة
1979,7097,0,3,"AL WARQA'A FIFTH",الورقاء الخامسة
1980,7097,0,3,"AL WARQA'A FIFTH",الورقاء الخامسة
1981,7097,4,7,"AL WARQA'A FIFTH",الورقاء الخامسة
1982,7097,0,7,"AL WARQA'A FIFTH",الورقاء الخامسة
1983,7097,1,8,"AL WARQA'A FIFTH",الورقاء الخامسة
1984,7097,1,9,"AL WARQA'A FIFTH",الورقاء الخامسة
1985,7097,0,9,"AL WARQA'A FIFTH",الورقاء الخامسة
1986,7097,1,10,"AL WARQA'A FIFTH",الورقاء الخامسة
1987,7097,0,10,"AL WARQA'A FIFTH",الورقاء الخامسة
1988,7097,0,10,"AL WARQA'A FIFTH",الورقاء الخامسة
1989,7097,5,15,"AL WARQA'A FIFTH",الورقاء الخامسة
1990,7097,5,20,"AL WARQA'A FIFTH",الورقاء الخامسة
1991,7097,4,24,"AL WARQA'A FIFTH",الورقاء الخامسة
1992,7097,4,28,"AL WARQA'A FIFTH",الورقاء الخامسة
1993,7097,4,32,"AL WARQA'A FIFTH",الورقاء الخامسة
1994,7097,4,36,"AL WARQA'A FIFTH",الورقاء الخامسة
1995,7097,0,36,"AL WARQA'A FIFTH",الورقاء الخامسة
1996,7097,0,36,"AL WARQA'A FIFTH",الورقاء الخامسة
1997,7097,1,37,"AL WARQA'A FIFTH",الورقاء الخامسة
1998,7097,2,39,"AL WARQA'A FIFTH",الورقاء الخامسة
1999,7097,1,40,"AL WARQA'A FIFTH",الورقاء الخامسة
2000,7097,2,42,"AL WARQA'A FIFTH",الورقاء الخامسة
2001,7097,0,42,"AL WARQA'A FIFTH",الورقاء الخامسة
2002,7097,1,43,"AL WARQA'A FIFTH",الورقاء الخامسة
2003,7097,0,43,"AL WARQA'A FIFTH",الورقاء الخامسة
2004,7097,0,43,"AL WARQA'A FIFTH",الورقاء الخامسة
2005,7097,2,45,"AL WARQA'A FIFTH",الورقاء الخامسة
2006,7097,0,45,"AL WARQA'A FIFTH",الورقاء الخامسة
2007,7097,3,48,"AL WARQA'A FIFTH",الورقاء الخامسة
2008,7097,0,48,"AL WARQA'A FIFTH",الورقاء الخامسة
2009,7097,0,48,"AL WARQA'A FIFTH",الورقاء الخامسة
2010,7097,1,49,"AL WARQA'A FIFTH",الورقاء الخامسة
2011,7097,0,49,"AL WARQA'A FIFTH",الورقاء الخامسة
2012,7097,0,49,"AL WARQA'A FIFTH",الورقاء الخامسة
2013,7097,0,49,"AL WARQA'A FIFTH",الورقاء الخامسة
2014,7097,0,49,"AL WARQA'A FIFTH",الورقاء الخامسة
2015,7097,0,49,"AL WARQA'A FIFTH",الورقاء الخامسة
2016,7097,0,49,"AL WARQA'A FIFTH",الورقاء الخامسة
2017,7097,0,49,"AL WARQA'A FIFTH",الورقاء الخامسة
2018,7097,2,51,"AL WARQA'A FIFTH",الورقاء الخامسة
2019,7097,0,51,"AL WARQA'A FIFTH",الورقاء الخامسة
2020,7097,2,53,"AL WARQA'A FIFTH",الورقاء الخامسة
2021,7097,0,53,"AL WARQA'A FIFTH",الورقاء الخامسة
1963,7137,0,0,AL YALAYIS 3,اليلايس 3
1964,7137,0,0,AL YALAYIS 3,اليلايس 3
1965,7137,0,0,AL YALAYIS 3,اليلايس 3
1966,7137,0,0,AL YALAYIS 3,اليلايس 3
1967,7137,0,0,AL YALAYIS 3,اليلايس 3
1968,7137,0,0,AL YALAYIS 3,اليلايس 3
1969,7137,0,0,AL YALAYIS 3,اليلايس 3
1970,7137,0,0,AL YALAYIS 3,اليلايس 3
1971,7137,0,0,AL YALAYIS 3,اليلايس 3
1972,7137,0,0,AL YALAYIS 3,اليلايس 3
1973,7137,0,0,AL YALAYIS 3,اليلايس 3
1974,7137,0,0,AL YALAYIS 3,اليلايس 3
1975,7137,0,0,AL YALAYIS 3,اليلايس 3
1976,7137,0,0,AL YALAYIS 3,اليلايس 3
1977,7137,0,0,AL YALAYIS 3,اليلايس 3
1978,7137,0,0,AL YALAYIS 3,اليلايس 3
1979,7137,0,0,AL YALAYIS 3,اليلايس 3
1980,7137,0,0,AL YALAYIS 3,اليلايس 3
1981,7137,0,0,AL YALAYIS 3,اليلايس 3
1982,7137,0,0,AL YALAYIS 3,اليلايس 3
1983,7137,0,0,AL YALAYIS 3,اليلايس 3
1984,7137,0,0,AL YALAYIS 3,اليلايس 3
1985,7137,0,0,AL YALAYIS 3,اليلايس 3
1986,7137,0,0,AL YALAYIS 3,اليلايس 3
1987,7137,0,0,AL YALAYIS 3,اليلايس 3
1988,7137,0,0,AL YALAYIS 3,اليلايس 3
1989,7137,0,0,AL YALAYIS 3,اليلايس 3
1990,7137,0,0,AL YALAYIS 3,اليلايس 3
1991,7137,0,0,AL YALAYIS 3,اليلايس 3
1992,7137,0,0,AL YALAYIS 3,اليلايس 3
1993,7137,0,0,AL YALAYIS 3,اليلايس 3
1994,7137,0,0,AL YALAYIS 3,اليلايس 3
1995,7137,0,0,AL YALAYIS 3,اليلايس 3
1996,7137,0,0,AL YALAYIS 3,اليلايس 3
1997,7137,0,0,AL YALAYIS 3,اليلايس 3
1998,7137,0,0,AL YALAYIS 3,اليلايس 3
1999,7137,0,0,AL YALAYIS 3,اليلايس 3
2000,7137,0,0,AL YALAYIS 3,اليلايس 3
2001,7137,0,0,AL YALAYIS 3,اليلايس 3
2002,7137,0,0,AL YALAYIS 3,اليلايس 3
2003,7137,0,0,AL YALAYIS 3,اليلايس 3
2004,7137,0,0,AL YALAYIS 3,اليلايس 3
2005,7137,0,0,AL YALAYIS 3,اليلايس 3
2006,7137,0,0,AL YALAYIS 3,اليلايس 3
2007,7137,0,0,AL YALAYIS 3,اليلايس 3
2008,7137,0,0,AL YALAYIS 3,اليلايس 3
2009,7137,0,0,AL YALAYIS 3,اليلايس 3
2010,7137,0,0,AL YALAYIS 3,اليلايس 3
2011,7137,0,0,AL YALAYIS 3,اليلايس 3
2012,7137,0,0,AL YALAYIS 3,اليلايس 3
2013,7137,0,0,AL YALAYIS 3,اليلايس 3
2014,7137,0,0,AL YALAYIS 3,اليلايس 3
2015,7137,0,0,AL YALAYIS 3,اليلايس 3
2016,7137,0,0,AL YALAYIS 3,اليلايس 3
2017,7137,0,0,AL YALAYIS 3,اليلايس 3
2018,7137,0,0,AL YALAYIS 3,اليلايس 3
2019,7137,0,0,AL YALAYIS 3,اليلايس 3
2020,7137,2,2,AL YALAYIS 3,اليلايس 3
2021,7137,0,2,AL YALAYIS 3,اليلايس 3
1963,7217,0,0,DUBAI INVESTMENT PARK SECOND,مجمع دبي للاستثمار الثاني
1964,7217,0,0,DUBAI INVESTMENT PARK SECOND,مجمع دبي للاستثمار الثاني
1965,7217,0,0,DUBAI INVESTMENT PARK SECOND,مجمع دبي للاستثمار الثاني
1966,7217,0,0,DUBAI INVESTMENT PARK SECOND,مجمع دبي للاستثمار الثاني
1967,7217,0,0,DUBAI INVESTMENT PARK SECOND,مجمع دبي للاستثمار الثاني
1968,7217,0,0,DUBAI INVESTMENT PARK SECOND,مجمع دبي للاستثمار الثاني
1969,7217,0,0,DUBAI INVESTMENT PARK SECOND,مجمع دبي للاستثمار الثاني
1970,7217,0,0,DUBAI INVESTMENT PARK SECOND,مجمع دبي للاستثمار الثاني
1971,7217,0,0,DUBAI INVESTMENT PARK SECOND,مجمع دبي للاستثمار الثاني
1972,7217,0,0,DUBAI INVESTMENT PARK SECOND,مجمع دبي للاستثمار الثاني
1973,7217,0,0,DUBAI INVESTMENT PARK SECOND,مجمع دبي للاستثمار الثاني
1974,7217,1,1,DUBAI INVESTMENT PARK SECOND,مجمع دبي للاستثمار الثاني
1975,7217,0,1,DUBAI INVESTMENT PARK SECOND,مجمع دبي للاستثمار الثاني
1976,7217,0,1,DUBAI INVESTMENT PARK SECOND,مجمع دبي للاستثمار الثاني
1977,7217,1,2,DUBAI INVESTMENT PARK SECOND,مجمع دبي للاستثمار الثاني
1978,7217,0,2,DUBAI INVESTMENT PARK SECOND,مجمع دبي للاستثمار الثاني
1979,7217,0,2,DUBAI INVESTMENT PARK SECOND,مجمع دبي للاستثمار الثاني
1980,7217,1,3,DUBAI INVESTMENT PARK SECOND,مجمع دبي للاستثمار الثاني
1981,7217,2,5,DUBAI INVESTMENT PARK SECOND,مجمع دبي للاستثمار الثاني
1982,7217,0,5,DUBAI INVESTMENT PARK SECOND,مجمع دبي للاستثمار الثاني
1983,7217,0,5,DUBAI INVESTMENT PARK SECOND,مجمع دبي للاستثمار الثاني
1984,7217,2,7,DUBAI INVESTMENT PARK SECOND,مجمع دبي للاستثمار الثاني
1985,7217,1,8,DUBAI INVESTMENT PARK SECOND,مجمع دبي للاستثمار الثاني
1986,7217,1,9,DUBAI INVESTMENT PARK SECOND,مجمع دبي للاستثمار الثاني
1987,7217,2,11,DUBAI INVESTMENT PARK SECOND,مجمع دبي للاستثمار الثاني
1988,7217,2,13,DUBAI INVESTMENT PARK SECOND,مجمع دبي للاستثمار الثاني
1989,7217,4,17,DUBAI INVESTMENT PARK SECOND,مجمع دبي للاستثمار الثاني
1990,7217,1,18,DUBAI INVESTMENT PARK SECOND,مجمع دبي للاستثمار الثاني
1991,7217,1,19,DUBAI INVESTMENT PARK SECOND,مجمع دبي للاستثمار الثاني
1992,7217,2,21,DUBAI INVESTMENT PARK SECOND,مجمع دبي للاستثمار الثاني
1993,7217,3,24,DUBAI INVESTMENT PARK SECOND,مجمع دبي للاستثمار الثاني
1994,7217,1,25,DUBAI INVESTMENT PARK SECOND,مجمع دبي للاستثمار الثاني
1995,7217,1,26,DUBAI INVESTMENT PARK SECOND,مجمع دبي للاستثمار الثاني
1996,7217,3,29,DUBAI INVESTMENT PARK SECOND,مجمع دبي للاستثمار الثاني
1997,7217,1,30,DUBAI INVESTMENT PARK SECOND,مجمع دبي للاستثمار الثاني
1998,7217,1,31,DUBAI INVESTMENT PARK SECOND,مجمع دبي للاستثمار الثاني
1999,7217,5,36,DUBAI INVESTMENT PARK SECOND,مجمع دبي للاستثمار الثاني
2000,7217,10,46,DUBAI INVESTMENT PARK SECOND,مجمع دبي للاستثمار الثاني
2001,7217,5,51,DUBAI INVESTMENT PARK SECOND,مجمع دبي للاستثمار الثاني
2002,7217,6,57,DUBAI INVESTMENT PARK SECOND,مجمع دبي للاستثمار الثاني
2003,7217,6,63,DUBAI INVESTMENT PARK SECOND,مجمع دبي للاستثمار الثاني
2004,7217,8,71,DUBAI INVESTMENT PARK SECOND,مجمع دبي للاستثمار الثاني
2005,7217,5,76,DUBAI INVESTMENT PARK SECOND,مجمع دبي للاستثمار الثاني
2006,7217,12,88,DUBAI INVESTMENT PARK SECOND,مجمع دبي للاستثمار الثاني
2007,7217,13,101,DUBAI INVESTMENT PARK SECOND,مجمع دبي للاستثمار الثاني
2008,7217,9,110,DUBAI INVESTMENT PARK SECOND,مجمع دبي للاستثمار الثاني
2009,7217,11,121,DUBAI INVESTMENT PARK SECOND,مجمع دبي للاستثمار الثاني
2010,7217,17,138,DUBAI INVESTMENT PARK SECOND,مجمع دبي للاستثمار الثاني
2011,7217,10,148,DUBAI INVESTMENT PARK SECOND,مجمع دبي للاستثمار الثاني
2012,7217,13,161,DUBAI INVESTMENT PARK SECOND,مجمع دبي للاستثمار الثاني
2013,7217,31,192,DUBAI INVESTMENT PARK SECOND,مجمع دبي للاستثمار الثاني
2014,7217,31,223,DUBAI INVESTMENT PARK SECOND,مجمع دبي للاستثمار الثاني
2015,7217,33,256,DUBAI INVESTMENT PARK SECOND,مجمع دبي للاستثمار الثاني
2016,7217,30,286,DUBAI INVESTMENT PARK SECOND,مجمع دبي للاستثمار الثاني
2017,7217,34,320,DUBAI INVESTMENT PARK SECOND,مجمع دبي للاستثمار الثاني
2018,7217,47,367,DUBAI INVESTMENT PARK SECOND,مجمع دبي للاستثمار الثاني
2019,7217,41,408,DUBAI INVESTMENT PARK SECOND,مجمع دبي للاستثمار الثاني
2020,7217,44,452,DUBAI INVESTMENT PARK SECOND,مجمع دبي للاستثمار الثاني
2021,7217,0,452,DUBAI INVESTMENT PARK SECOND,مجمع دبي للاستثمار الثاني
1963,7297,0,0,UMM SUQEIM SECOND,أم سقيم الثانية
1964,7297,0,0,UMM SUQEIM SECOND,أم سقيم الثانية
1965,7297,0,0,UMM SUQEIM SECOND,أم سقيم الثانية
1966,7297,0,0,UMM SUQEIM SECOND,أم سقيم الثانية
1967,7297,0,0,UMM SUQEIM SECOND,أم سقيم الثانية
1968,7297,0,0,UMM SUQEIM SECOND,أم سقيم الثانية
1969,7297,0,0,UMM SUQEIM SECOND,أم سقيم الثانية
1970,7297,0,0,UMM SUQEIM SECOND,أم سقيم الثانية
1971,7297,0,0,UMM SUQEIM SECOND,أم سقيم الثانية
1972,7297,1,1,UMM SUQEIM SECOND,أم سقيم الثانية
1973,7297,0,1,UMM SUQEIM SECOND,أم سقيم الثانية
1974,7297,0,1,UMM SUQEIM SECOND,أم سقيم الثانية
1975,7297,0,1,UMM SUQEIM SECOND,أم سقيم الثانية
1976,7297,0,1,UMM SUQEIM SECOND,أم سقيم الثانية
1977,7297,0,1,UMM SUQEIM SECOND,أم سقيم الثانية
1978,7297,0,1,UMM SUQEIM SECOND,أم سقيم الثانية
1979,7297,0,1,UMM SUQEIM SECOND,أم سقيم الثانية
1980,7297,0,1,UMM SUQEIM SECOND,أم سقيم الثانية
1981,7297,0,1,UMM SUQEIM SECOND,أم سقيم الثانية
1982,7297,0,1,UMM SUQEIM SECOND,أم سقيم الثانية
1983,7297,0,1,UMM SUQEIM SECOND,أم سقيم الثانية
1984,7297,1,2,UMM SUQEIM SECOND,أم سقيم الثانية
1985,7297,0,2,UMM SUQEIM SECOND,أم سقيم الثانية
1986,7297,0,2,UMM SUQEIM SECOND,أم سقيم الثانية
1987,7297,0,2,UMM SUQEIM SECOND,أم سقيم الثانية
1988,7297,1,3,UMM SUQEIM SECOND,أم سقيم الثانية
1989,7297,1,4,UMM SUQEIM SECOND,أم سقيم الثانية
1990,7297,0,4,UMM SUQEIM SECOND,أم سقيم الثانية
1991,7297,1,5,UMM SUQEIM SECOND,أم سقيم الثانية
1992,7297,1,6,UMM SUQEIM SECOND,أم سقيم الثانية
1993,7297,0,6,UMM SUQEIM SECOND,أم سقيم الثانية
1994,7297,1,7,UMM SUQEIM SECOND,أم سقيم الثانية
1995,7297,0,7,UMM SUQEIM SECOND,أم سقيم الثانية
1996,7297,0,7,UMM SUQEIM SECOND,أم سقيم الثانية
1997,7297,1,8,UMM SUQEIM SECOND,أم سقيم الثانية
1998,7297,0,8,UMM SUQEIM SECOND,أم سقيم الثانية
1999,7297,0,8,UMM SUQEIM SECOND,أم سقيم الثانية
2000,7297,0,8,UMM SUQEIM SECOND,أم سقيم الثانية
2001,7297,0,8,UMM SUQEIM SECOND,أم سقيم الثانية
2002,7297,3,11,UMM SUQEIM SECOND,أم سقيم الثانية
2003,7297,1,12,UMM SUQEIM SECOND,أم سقيم الثانية
2004,7297,0,12,UMM SUQEIM SECOND,أم سقيم الثانية
2005,7297,1,13,UMM SUQEIM SECOND,أم سقيم الثانية
2006,7297,1,14,UMM SUQEIM SECOND,أم سقيم الثانية
2007,7297,1,15,UMM SUQEIM SECOND,أم سقيم الثانية
2008,7297,2,17,UMM SUQEIM SECOND,أم سقيم الثانية
2009,7297,2,19,UMM SUQEIM SECOND,أم سقيم الثانية
2010,7297,4,23,UMM SUQEIM SECOND,أم سقيم الثانية
2011,7297,3,26,UMM SUQEIM SECOND,أم سقيم الثانية
2012,7297,6,32,UMM SUQEIM SECOND,أم سقيم الثانية
2013,7297,7,39,UMM SUQEIM SECOND,أم سقيم الثانية
2014,7297,5,44,UMM SUQEIM SECOND,أم سقيم الثانية
2015,7297,12,56,UMM SUQEIM SECOND,أم سقيم الثانية
2016,7297,8,64,UMM SUQEIM SECOND,أم سقيم الثانية
2017,7297,5,69,UMM SUQEIM SECOND,أم سقيم الثانية
2018,7297,17,86,UMM SUQEIM SECOND,أم سقيم الثانية
2019,7297,33,119,UMM SUQEIM SECOND,أم سقيم الثانية
2020,7297,49,168,UMM SUQEIM SECOND,أم سقيم الثانية
2021,7297,0,168,UMM SUQEIM SECOND,أم سقيم الثانية
1963,7377,0,0,SAIH AL SALAM,سيح السلم
1964,7377,0,0,SAIH AL SALAM,سيح السلم
1965,7377,0,0,SAIH AL SALAM,سيح السلم
1966,7377,0,0,SAIH AL SALAM,سيح السلم
1967,7377,0,0,SAIH AL SALAM,سيح السلم
1968,7377,0,0,SAIH AL SALAM,سيح السلم
1969,7377,0,0,SAIH AL SALAM,سيح السلم
1970,7377,0,0,SAIH AL SALAM,سيح السلم
1971,7377,0,0,SAIH AL SALAM,سيح السلم
1972,7377,0,0,SAIH AL SALAM,سيح السلم
1973,7377,0,0,SAIH AL SALAM,سيح السلم
1974,7377,0,0,SAIH AL SALAM,سيح السلم
1975,7377,1,1,SAIH AL SALAM,سيح السلم
1976,7377,0,1,SAIH AL SALAM,سيح السلم
1977,7377,0,1,SAIH AL SALAM,سيح السلم
1978,7377,2,3,SAIH AL SALAM,سيح السلم
1979,7377,0,3,SAIH AL SALAM,سيح السلم
1980,7377,0,3,SAIH AL SALAM,سيح السلم
1981,7377,1,4,SAIH AL SALAM,سيح السلم
1982,7377,0,4,SAIH AL SALAM,سيح السلم
1983,7377,0,4,SAIH AL SALAM,سيح السلم
1984,7377,0,4,SAIH AL SALAM,سيح السلم
1985,7377,0,4,SAIH AL SALAM,سيح السلم
1986,7377,0,4,SAIH AL SALAM,سيح السلم
1987,7377,0,4,SAIH AL SALAM,سيح السلم
1988,7377,1,5,SAIH AL SALAM,سيح السلم
1989,7377,2,7,SAIH AL SALAM,سيح السلم
1990,7377,0,7,SAIH AL SALAM,سيح السلم
1991,7377,2,9,SAIH AL SALAM,سيح السلم
1992,7377,0,9,SAIH AL SALAM,سيح السلم
1993,7377,1,10,SAIH AL SALAM,سيح السلم
1994,7377,1,11,SAIH AL SALAM,سيح السلم
1995,7377,0,11,SAIH AL SALAM,سيح السلم
1996,7377,2,13,SAIH AL SALAM,سيح السلم
1997,7377,3,16,SAIH AL SALAM,سيح السلم
1998,7377,1,17,SAIH AL SALAM,سيح السلم
1999,7377,0,17,SAIH AL SALAM,سيح السلم
2000,7377,0,17,SAIH AL SALAM,سيح السلم
2001,7377,3,20,SAIH AL SALAM,سيح السلم
2002,7377,4,24,SAIH AL SALAM,سيح السلم
2003,7377,4,28,SAIH AL SALAM,سيح السلم
2004,7377,3,31,SAIH AL SALAM,سيح السلم
2005,7377,3,34,SAIH AL SALAM,سيح السلم
2006,7377,2,36,SAIH AL SALAM,سيح السلم
2007,7377,7,43,SAIH AL SALAM,سيح السلم
2008,7377,5,48,SAIH AL SALAM,سيح السلم
2009,7377,6,54,SAIH AL SALAM,سيح السلم
2010,7377,6,60,SAIH AL SALAM,سيح السلم
2011,7377,6,66,SAIH AL SALAM,سيح السلم
2012,7377,10,76,SAIH AL SALAM,سيح السلم
2013,7377,12,88,SAIH AL SALAM,سيح السلم
2014,7377,16,104,SAIH AL SALAM,سيح السلم
2015,7377,28,132,SAIH AL SALAM,سيح السلم
2016,7377,51,183,SAIH AL SALAM,سيح السلم
2017,7377,25,208,SAIH AL SALAM,سيح السلم
2018,7377,35,243,SAIH AL SALAM,سيح السلم
2019,7377,43,286,SAIH AL SALAM,سيح السلم
2020,7377,197,483,SAIH AL SALAM,سيح السلم
2021,7377,0,483,SAIH AL SALAM,سيح السلم
1963,7457,1,1,NADD AL HAMAR,ند الحمر
1964,7457,0,1,NADD AL HAMAR,ند الحمر
1965,7457,0,1,NADD AL HAMAR,ند الحمر
1966,7457,0,1,NADD AL HAMAR,ند الحمر
1967,7457,0,1,NADD AL HAMAR,ند الحمر
1968,7457,0,1,NADD AL HAMAR,ند الحمر
1969,7457,0,1,NADD AL HAMAR,ند الحمر
1970,7457,1,2,NADD AL HAMAR,ند الحمر
1971,7457,0,2,NADD AL HAMAR,ند الحمر
1972,7457,0,2,NADD AL HAMAR,ند الحمر
1973,7457,0,2,NADD AL HAMAR,ند الحمر
1974,7457,1,3,NADD AL HAMAR,ند الحمر
1975,7457,0,3,NADD AL HAMAR,ند الحمر
1976,7457,2,5,NADD AL HAMAR,ند الحمر
1977,7457,1,6,NADD AL HAMAR,ند الحمر
1978,7457,0,6,NADD AL HAMAR,ند الحمر
1979,7457,0,6,NADD AL HAMAR,ند الحمر
1980,7457,0,6,NADD AL HAMAR,ند الحمر
1981,7457,1,7,NADD AL HAMAR,ند الحمر
1982,7457,2,9,NADD AL HAMAR,ند الحمر
1983,7457,1,10,NADD AL HAMAR,ند الحمر
1984,7457,0,10,NADD AL HAMAR,ند الحمر
1985,7457,1,11,NADD AL HAMAR,ند الحمر
1986,7457,0,11,NADD AL HAMAR,ند الحمر
1987,7457,1,12,NADD AL HAMAR,ند الحمر
1988,7457,1,13,NADD AL HAMAR,ند الحمر
1989,7457,3,16,NADD AL HAMAR,ند الحمر
1990,7457,1,17,NADD AL HAMAR,ند الحمر
1991,7457,3,20,NADD AL HAMAR,ند الحمر
1992,7457,1,21,NADD AL HAMAR,ند الحمر
1993,7457,0,21,NADD AL HAMAR,ند الحمر
1994,7457,6,27,NADD AL HAMAR,ند الحمر
1995,7457,4,31,NADD AL HAMAR,ند الحمر
1996,7457,4,35,NADD AL HAMAR,ند الحمر
1997,7457,1,36,NADD AL HAMAR,ند الحمر
1998,7457,0,36,NADD AL HAMAR,ند الحمر
1999,7457,0,36,NADD AL HAMAR,ند الحمر
2000,7457,4,40,NADD AL HAMAR,ند الحمر
2001,7457,4,44,NADD AL HAMAR,ند الحمر
2002,7457,5,49,NADD AL HAMAR,ند الحمر
2003,7457,6,55,NADD AL HAMAR,ند الحمر
2004,7457,12,67,NADD AL HAMAR,ند الحمر
2005,7457,10,77,NADD AL HAMAR,ند الحمر
2006,7457,8,85,NADD AL HAMAR,ند الحمر
2007,7457,9,94,NADD AL HAMAR,ند الحمر
2008,7457,14,108,NADD AL HAMAR,ند الحمر
2009,7457,7,115,NADD AL HAMAR,ند الحمر
2010,7457,16,131,NADD AL HAMAR,ند الحمر
2011,7457,21,152,NADD AL HAMAR,ند الحمر
2012,7457,17,169,NADD AL HAMAR,ند الحمر
2013,7457,19,188,NADD AL HAMAR,ند الحمر
2014,7457,26,214,NADD AL HAMAR,ند الحمر
2015,7457,34,248,NADD AL HAMAR,ند الحمر
2016,7457,32,280,NADD AL HAMAR,ند الحمر
2017,7457,35,315,NADD AL HAMAR,ند الحمر
2018,7457,33,348,NADD AL HAMAR,ند الحمر
2019,7457,52,400,NADD AL HAMAR,ند الحمر
2020,7457,171,571,NADD AL HAMAR,ند الحمر
2021,7457,0,571,NADD AL HAMAR,ند الحمر
1963,7497,0,0,UMM NAHAD SECOND,أم نهد الثانية
1964,7497,0,0,UMM NAHAD SECOND,أم نهد الثانية
1965,7497,0,0,UMM NAHAD SECOND,أم نهد الثانية
1966,7497,0,0,UMM NAHAD SECOND,أم نهد الثانية
1967,7497,0,0,UMM NAHAD SECOND,أم نهد الثانية
1968,7497,0,0,UMM NAHAD SECOND,أم نهد الثانية
1969,7497,0,0,UMM NAHAD SECOND,أم نهد الثانية
1970,7497,0,0,UMM NAHAD SECOND,أم نهد الثانية
1971,7497,0,0,UMM NAHAD SECOND,أم نهد الثانية
1972,7497,0,0,UMM NAHAD SECOND,أم نهد الثانية
1973,7497,0,0,UMM NAHAD SECOND,أم نهد الثانية
1974,7497,0,0,UMM NAHAD SECOND,أم نهد الثانية
1975,7497,0,0,UMM NAHAD SECOND,أم نهد الثانية
1976,7497,0,0,UMM NAHAD SECOND,أم نهد الثانية
1977,7497,0,0,UMM NAHAD SECOND,أم نهد الثانية
1978,7497,0,0,UMM NAHAD SECOND,أم نهد الثانية
1979,7497,0,0,UMM NAHAD SECOND,أم نهد الثانية
1980,7497,0,0,UMM NAHAD SECOND,أم نهد الثانية
1981,7497,0,0,UMM NAHAD SECOND,أم نهد الثانية
1982,7497,0,0,UMM NAHAD SECOND,أم نهد الثانية
1983,7497,0,0,UMM NAHAD SECOND,أم نهد الثانية
1984,7497,0,0,UMM NAHAD SECOND,أم نهد الثانية
1985,7497,0,0,UMM NAHAD SECOND,أم نهد الثانية
1986,7497,0,0,UMM NAHAD SECOND,أم نهد الثانية
1987,7497,0,0,UMM NAHAD SECOND,أم نهد الثانية
1988,7497,0,0,UMM NAHAD SECOND,أم نهد الثانية
1989,7497,0,0,UMM NAHAD SECOND,أم نهد الثانية
1990,7497,0,0,UMM NAHAD SECOND,أم نهد الثانية
1991,7497,0,0,UMM NAHAD SECOND,أم نهد الثانية
1992,7497,0,0,UMM NAHAD SECOND,أم نهد الثانية
1993,7497,0,0,UMM NAHAD SECOND,أم نهد الثانية
1994,7497,0,0,UMM NAHAD SECOND,أم نهد الثانية
1995,7497,0,0,UMM NAHAD SECOND,أم نهد الثانية
1996,7497,0,0,UMM NAHAD SECOND,أم نهد الثانية
1997,7497,0,0,UMM NAHAD SECOND,أم نهد الثانية
1998,7497,1,1,UMM NAHAD SECOND,أم نهد الثانية
1999,7497,0,1,UMM NAHAD SECOND,أم نهد الثانية
2000,7497,0,1,UMM NAHAD SECOND,أم نهد الثانية
2001,7497,0,1,UMM NAHAD SECOND,أم نهد الثانية
2002,7497,0,1,UMM NAHAD SECOND,أم نهد الثانية
2003,7497,0,1,UMM NAHAD SECOND,أم نهد الثانية
2004,7497,0,1,UMM NAHAD SECOND,أم نهد الثانية
2005,7497,1,2,UMM NAHAD SECOND,أم نهد الثانية
2006,7497,0,2,UMM NAHAD SECOND,أم نهد الثانية
2007,7497,0,2,UMM NAHAD SECOND,أم نهد الثانية
2008,7497,0,2,UMM NAHAD SECOND,أم نهد الثانية
2009,7497,0,2,UMM NAHAD SECOND,أم نهد الثانية
2010,7497,1,3,UMM NAHAD SECOND,أم نهد الثانية
2011,7497,0,3,UMM NAHAD SECOND,أم نهد الثانية
2012,7497,0,3,UMM NAHAD SECOND,أم نهد الثانية
2013,7497,2,5,UMM NAHAD SECOND,أم نهد الثانية
2014,7497,0,5,UMM NAHAD SECOND,أم نهد الثانية
2015,7497,0,5,UMM NAHAD SECOND,أم نهد الثانية
2016,7497,0,5,UMM NAHAD SECOND,أم نهد الثانية
2017,7497,0,5,UMM NAHAD SECOND,أم نهد الثانية
2018,7497,0,5,UMM NAHAD SECOND,أم نهد الثانية
2019,7497,0,5,UMM NAHAD SECOND,أم نهد الثانية
2020,7497,1,6,UMM NAHAD SECOND,أم نهد الثانية
2021,7497,0,6,UMM NAHAD SECOND,أم نهد الثانية
1963,7537,0,0,AL YALAYIS 5,اليلايس 5
1964,7537,0,0,AL YALAYIS 5,اليلايس 5
1965,7537,0,0,AL YALAYIS 5,اليلايس 5
1966,7537,0,0,AL YALAYIS 5,اليلايس 5
1967,7537,0,0,AL YALAYIS 5,اليلايس 5
1968,7537,0,0,AL YALAYIS 5,اليلايس 5
1969,7537,0,0,AL YALAYIS 5,اليلايس 5
1970,7537,0,0,AL YALAYIS 5,اليلايس 5
1971,7537,0,0,AL YALAYIS 5,اليلايس 5
1972,7537,0,0,AL YALAYIS 5,اليلايس 5
1973,7537,0,0,AL YALAYIS 5,اليلايس 5
1974,7537,0,0,AL YALAYIS 5,اليلايس 5
1975,7537,0,0,AL YALAYIS 5,اليلايس 5
1976,7537,0,0,AL YALAYIS 5,اليلايس 5
1977,7537,0,0,AL YALAYIS 5,اليلايس 5
1978,7537,0,0,AL YALAYIS 5,اليلايس 5
1979,7537,0,0,AL YALAYIS 5,اليلايس 5
1980,7537,0,0,AL YALAYIS 5,اليلايس 5
1981,7537,0,0,AL YALAYIS 5,اليلايس 5
1982,7537,0,0,AL YALAYIS 5,اليلايس 5
1983,7537,0,0,AL YALAYIS 5,اليلايس 5
1984,7537,0,0,AL YALAYIS 5,اليلايس 5
1985,7537,0,0,AL YALAYIS 5,اليلايس 5
1986,7537,0,0,AL YALAYIS 5,اليلايس 5
1987,7537,0,0,AL YALAYIS 5,اليلايس 5
1988,7537,0,0,AL YALAYIS 5,اليلايس 5
1989,7537,0,0,AL YALAYIS 5,اليلايس 5
1990,7537,0,0,AL YALAYIS 5,اليلايس 5
1991,7537,0,0,AL YALAYIS 5,اليلايس 5
1992,7537,0,0,AL YALAYIS 5,اليلايس 5
1993,7537,0,0,AL YALAYIS 5,اليلايس 5
1994,7537,0,0,AL YALAYIS 5,اليلايس 5
1995,7537,0,0,AL YALAYIS 5,اليلايس 5
1996,7537,0,0,AL YALAYIS 5,اليلايس 5
1997,7537,0,0,AL YALAYIS 5,اليلايس 5
1998,7537,0,0,AL YALAYIS 5,اليلايس 5
1999,7537,0,0,AL YALAYIS 5,اليلايس 5
2000,7537,0,0,AL YALAYIS 5,اليلايس 5
2001,7537,0,0,AL YALAYIS 5,اليلايس 5
2002,7537,0,0,AL YALAYIS 5,اليلايس 5
2003,7537,0,0,AL YALAYIS 5,اليلايس 5
2004,7537,0,0,AL YALAYIS 5,اليلايس 5
2005,7537,0,0,AL YALAYIS 5,اليلايس 5
2006,7537,0,0,AL YALAYIS 5,اليلايس 5
2007,7537,0,0,AL YALAYIS 5,اليلايس 5
2008,7537,0,0,AL YALAYIS 5,اليلايس 5
2009,7537,0,0,AL YALAYIS 5,اليلايس 5
2010,7537,0,0,AL YALAYIS 5,اليلايس 5
2011,7537,0,0,AL YALAYIS 5,اليلايس 5
2012,7537,0,0,AL YALAYIS 5,اليلايس 5
2013,7537,0,0,AL YALAYIS 5,اليلايس 5
2014,7537,0,0,AL YALAYIS 5,اليلايس 5
2015,7537,0,0,AL YALAYIS 5,اليلايس 5
2016,7537,0,0,AL YALAYIS 5,اليلايس 5
2017,7537,0,0,AL YALAYIS 5,اليلايس 5
2018,7537,0,0,AL YALAYIS 5,اليلايس 5
2019,7537,1,1,AL YALAYIS 5,اليلايس 5
2020,7537,4,5,AL YALAYIS 5,اليلايس 5
2021,7537,0,5,AL YALAYIS 5,اليلايس 5
1963,7577,0,0,MUHAISANAH THIRD,محيصنة الثالثة
1964,7577,0,0,MUHAISANAH THIRD,محيصنة الثالثة
1965,7577,0,0,MUHAISANAH THIRD,محيصنة الثالثة
1966,7577,0,0,MUHAISANAH THIRD,محيصنة الثالثة
1967,7577,0,0,MUHAISANAH THIRD,محيصنة الثالثة
1968,7577,0,0,MUHAISANAH THIRD,محيصنة الثالثة
1969,7577,0,0,MUHAISANAH THIRD,محيصنة الثالثة
1970,7577,0,0,MUHAISANAH THIRD,محيصنة الثالثة
1971,7577,0,0,MUHAISANAH THIRD,محيصنة الثالثة
1972,7577,0,0,MUHAISANAH THIRD,محيصنة الثالثة
1973,7577,0,0,MUHAISANAH THIRD,محيصنة الثالثة
1974,7577,0,0,MUHAISANAH THIRD,محيصنة الثالثة
1975,7577,0,0,MUHAISANAH THIRD,محيصنة الثالثة
1976,7577,0,0,MUHAISANAH THIRD,محيصنة الثالثة
1977,7577,0,0,MUHAISANAH THIRD,محيصنة الثالثة
1978,7577,0,0,MUHAISANAH THIRD,محيصنة الثالثة
1979,7577,0,0,MUHAISANAH THIRD,محيصنة الثالثة
1980,7577,0,0,MUHAISANAH THIRD,محيصنة الثالثة
1981,7577,0,0,MUHAISANAH THIRD,محيصنة الثالثة
1982,7577,0,0,MUHAISANAH THIRD,محيصنة الثالثة
1983,7577,0,0,MUHAISANAH THIRD,محيصنة الثالثة
1984,7577,0,0,MUHAISANAH THIRD,محيصنة الثالثة
1985,7577,0,0,MUHAISANAH THIRD,محيصنة الثالثة
1986,7577,0,0,MUHAISANAH THIRD,محيصنة الثالثة
1987,7577,0,0,MUHAISANAH THIRD,محيصنة الثالثة
1988,7577,0,0,MUHAISANAH THIRD,محيصنة الثالثة
1989,7577,0,0,MUHAISANAH THIRD,محيصنة الثالثة
1990,7577,0,0,MUHAISANAH THIRD,محيصنة الثالثة
1991,7577,0,0,MUHAISANAH THIRD,محيصنة الثالثة
1992,7577,0,0,MUHAISANAH THIRD,محيصنة الثالثة
1993,7577,0,0,MUHAISANAH THIRD,محيصنة الثالثة
1994,7577,0,0,MUHAISANAH THIRD,محيصنة الثالثة
1995,7577,0,0,MUHAISANAH THIRD,محيصنة الثالثة
1996,7577,0,0,MUHAISANAH THIRD,محيصنة الثالثة
1997,7577,0,0,MUHAISANAH THIRD,محيصنة الثالثة
1998,7577,0,0,MUHAISANAH THIRD,محيصنة الثالثة
1999,7577,0,0,MUHAISANAH THIRD,محيصنة الثالثة
2000,7577,0,0,MUHAISANAH THIRD,محيصنة الثالثة
2001,7577,0,0,MUHAISANAH THIRD,محيصنة الثالثة
2002,7577,0,0,MUHAISANAH THIRD,محيصنة الثالثة
2003,7577,0,0,MUHAISANAH THIRD,محيصنة الثالثة
2004,7577,1,1,MUHAISANAH THIRD,محيصنة الثالثة
2005,7577,0,1,MUHAISANAH THIRD,محيصنة الثالثة
2006,7577,0,1,MUHAISANAH THIRD,محيصنة الثالثة
2007,7577,0,1,MUHAISANAH THIRD,محيصنة الثالثة
2008,7577,1,2,MUHAISANAH THIRD,محيصنة الثالثة
2009,7577,0,2,MUHAISANAH THIRD,محيصنة الثالثة
2010,7577,0,2,MUHAISANAH THIRD,محيصنة الثالثة
2011,7577,0,2,MUHAISANAH THIRD,محيصنة الثالثة
2012,7577,0,2,MUHAISANAH THIRD,محيصنة الثالثة
2013,7577,1,3,MUHAISANAH THIRD,محيصنة الثالثة
2014,7577,2,5,MUHAISANAH THIRD,محيصنة الثالثة
2015,7577,1,6,MUHAISANAH THIRD,محيصنة الثالثة
2016,7577,2,8,MUHAISANAH THIRD,محيصنة الثالثة
2017,7577,3,11,MUHAISANAH THIRD,محيصنة الثالثة
2018,7577,2,13,MUHAISANAH THIRD,محيصنة الثالثة
2019,7577,10,23,MUHAISANAH THIRD,محيصنة الثالثة
2020,7577,25,48,MUHAISANAH THIRD,محيصنة الثالثة
2021,7577,0,48,MUHAISANAH THIRD,محيصنة الثالثة
1963,7617,0,0,MUHAISANAH FIFTH,محيصنة الخامسة
1964,7617,0,0,MUHAISANAH FIFTH,محيصنة الخامسة
1965,7617,0,0,MUHAISANAH FIFTH,محيصنة الخامسة
1966,7617,0,0,MUHAISANAH FIFTH,محيصنة الخامسة
1967,7617,0,0,MUHAISANAH FIFTH,محيصنة الخامسة
1968,7617,0,0,MUHAISANAH FIFTH,محيصنة الخامسة
1969,7617,0,0,MUHAISANAH FIFTH,محيصنة الخامسة
1970,7617,0,0,MUHAISANAH FIFTH,محيصنة الخامسة
1971,7617,0,0,MUHAISANAH FIFTH,محيصنة الخامسة
1972,7617,0,0,MUHAISANAH FIFTH,محيصنة الخامسة
1973,7617,0,0,MUHAISANAH FIFTH,محيصنة الخامسة
1974,7617,0,0,MUHAISANAH FIFTH,محيصنة الخامسة
1975,7617,0,0,MUHAISANAH FIFTH,محيصنة الخامسة
1976,7617,0,0,MUHAISANAH FIFTH,محيصنة الخامسة
1977,7617,0,0,MUHAISANAH FIFTH,محيصنة الخامسة
1978,7617,0,0,MUHAISANAH FIFTH,محيصنة الخامسة
1979,7617,0,0,MUHAISANAH FIFTH,محيصنة الخامسة
1980,7617,0,0,MUHAISANAH FIFTH,محيصنة الخامسة
1981,7617,0,0,MUHAISANAH FIFTH,محيصنة الخامسة
1982,7617,0,0,MUHAISANAH FIFTH,محيصنة الخامسة
1983,7617,0,0,MUHAISANAH FIFTH,محيصنة الخامسة
1984,7617,0,0,MUHAISANAH FIFTH,محيصنة الخامسة
1985,7617,0,0,MUHAISANAH FIFTH,محيصنة الخامسة
1986,7617,0,0,MUHAISANAH FIFTH,محيصنة الخامسة
1987,7617,0,0,MUHAISANAH FIFTH,محيصنة الخامسة
1988,7617,0,0,MUHAISANAH FIFTH,محيصنة الخامسة
1989,7617,0,0,MUHAISANAH FIFTH,محيصنة الخامسة
1990,7617,0,0,MUHAISANAH FIFTH,محيصنة الخامسة
1991,7617,0,0,MUHAISANAH FIFTH,محيصنة الخامسة
1992,7617,0,0,MUHAISANAH FIFTH,محيصنة الخامسة
1993,7617,0,0,MUHAISANAH FIFTH,محيصنة الخامسة
1994,7617,0,0,MUHAISANAH FIFTH,محيصنة الخامسة
1995,7617,0,0,MUHAISANAH FIFTH,محيصنة الخامسة
1996,7617,0,0,MUHAISANAH FIFTH,محيصنة الخامسة
1997,7617,0,0,MUHAISANAH FIFTH,محيصنة الخامسة
1998,7617,0,0,MUHAISANAH FIFTH,محيصنة الخامسة
1999,7617,0,0,MUHAISANAH FIFTH,محيصنة الخامسة
2000,7617,0,0,MUHAISANAH FIFTH,محيصنة الخامسة
2001,7617,0,0,MUHAISANAH FIFTH,محيصنة الخامسة
2002,7617,0,0,MUHAISANAH FIFTH,محيصنة الخامسة
2003,7617,0,0,MUHAISANAH FIFTH,محيصنة الخامسة
2004,7617,0,0,MUHAISANAH FIFTH,محيصنة الخامسة
2005,7617,0,0,MUHAISANAH FIFTH,محيصنة الخامسة
2006,7617,0,0,MUHAISANAH FIFTH,محيصنة الخامسة
2007,7617,0,0,MUHAISANAH FIFTH,محيصنة الخامسة
2008,7617,1,1,MUHAISANAH FIFTH,محيصنة الخامسة
2009,7617,0,1,MUHAISANAH FIFTH,محيصنة الخامسة
2010,7617,0,1,MUHAISANAH FIFTH,محيصنة الخامسة
2011,7617,0,1,MUHAISANAH FIFTH,محيصنة الخامسة
2012,7617,0,1,MUHAISANAH FIFTH,محيصنة الخامسة
2013,7617,1,2,MUHAISANAH FIFTH,محيصنة الخامسة
2014,7617,1,3,MUHAISANAH FIFTH,محيصنة الخامسة
2015,7617,0,3,MUHAISANAH FIFTH,محيصنة الخامسة
2016,7617,0,3,MUHAISANAH FIFTH,محيصنة الخامسة
2017,7617,0,3,MUHAISANAH FIFTH,محيصنة الخامسة
2018,7617,2,5,MUHAISANAH FIFTH,محيصنة الخامسة
2019,7617,1,6,MUHAISANAH FIFTH,محيصنة الخامسة
2020,7617,1,7,MUHAISANAH FIFTH,محيصنة الخامسة
2021,7617,0,7,MUHAISANAH FIFTH,محيصنة الخامسة
1963,7657,0,0,DUBAI INVESTMENT PARK FIRST,مجمع دبي للاستثمار الأول
1964,7657,0,0,DUBAI INVESTMENT PARK FIRST,مجمع دبي للاستثمار الأول
1965,7657,0,0,DUBAI INVESTMENT PARK FIRST,مجمع دبي للاستثمار الأول
1966,7657,0,0,DUBAI INVESTMENT PARK FIRST,مجمع دبي للاستثمار الأول
1967,7657,0,0,DUBAI INVESTMENT PARK FIRST,مجمع دبي للاستثمار الأول
1968,7657,0,0,DUBAI INVESTMENT PARK FIRST,مجمع دبي للاستثمار الأول
1969,7657,0,0,DUBAI INVESTMENT PARK FIRST,مجمع دبي للاستثمار الأول
1970,7657,0,0,DUBAI INVESTMENT PARK FIRST,مجمع دبي للاستثمار الأول
1971,7657,0,0,DUBAI INVESTMENT PARK FIRST,مجمع دبي للاستثمار الأول
1972,7657,0,0,DUBAI INVESTMENT PARK FIRST,مجمع دبي للاستثمار الأول
1973,7657,0,0,DUBAI INVESTMENT PARK FIRST,مجمع دبي للاستثمار الأول
1974,7657,1,1,DUBAI INVESTMENT PARK FIRST,مجمع دبي للاستثمار الأول
1975,7657,2,3,DUBAI INVESTMENT PARK FIRST,مجمع دبي للاستثمار الأول
1976,7657,2,5,DUBAI INVESTMENT PARK FIRST,مجمع دبي للاستثمار الأول
1977,7657,1,6,DUBAI INVESTMENT PARK FIRST,مجمع دبي للاستثمار الأول
1978,7657,2,8,DUBAI INVESTMENT PARK FIRST,مجمع دبي للاستثمار الأول
1979,7657,0,8,DUBAI INVESTMENT PARK FIRST,مجمع دبي للاستثمار الأول
1980,7657,1,9,DUBAI INVESTMENT PARK FIRST,مجمع دبي للاستثمار الأول
1981,7657,0,9,DUBAI INVESTMENT PARK FIRST,مجمع دبي للاستثمار الأول
1982,7657,3,12,DUBAI INVESTMENT PARK FIRST,مجمع دبي للاستثمار الأول
1983,7657,1,13,DUBAI INVESTMENT PARK FIRST,مجمع دبي للاستثمار الأول
1984,7657,0,13,DUBAI INVESTMENT PARK FIRST,مجمع دبي للاستثمار الأول
1985,7657,0,13,DUBAI INVESTMENT PARK FIRST,مجمع دبي للاستثمار الأول
1986,7657,2,15,DUBAI INVESTMENT PARK FIRST,مجمع دبي للاستثمار الأول
1987,7657,2,17,DUBAI INVESTMENT PARK FIRST,مجمع دبي للاستثمار الأول
1988,7657,1,18,DUBAI INVESTMENT PARK FIRST,مجمع دبي للاستثمار الأول
1989,7657,5,23,DUBAI INVESTMENT PARK FIRST,مجمع دبي للاستثمار الأول
1990,7657,4,27,DUBAI INVESTMENT PARK FIRST,مجمع دبي للاستثمار الأول
1991,7657,6,33,DUBAI INVESTMENT PARK FIRST,مجمع دبي للاستثمار الأول
1992,7657,4,37,DUBAI INVESTMENT PARK FIRST,مجمع دبي للاستثمار الأول
1993,7657,5,42,DUBAI INVESTMENT PARK FIRST,مجمع دبي للاستثمار الأول
1994,7657,8,50,DUBAI INVESTMENT PARK FIRST,مجمع دبي للاستثمار الأول
1995,7657,3,53,DUBAI INVESTMENT PARK FIRST,مجمع دبي للاستثمار الأول
1996,7657,5,58,DUBAI INVESTMENT PARK FIRST,مجمع دبي للاستثمار الأول
1997,7657,5,63,DUBAI INVESTMENT PARK FIRST,مجمع دبي للاستثمار الأول
1998,7657,7,70,DUBAI INVESTMENT PARK FIRST,مجمع دبي للاستثمار الأول
1999,7657,10,80,DUBAI INVESTMENT PARK FIRST,مجمع دبي للاستثمار الأول
2000,7657,7,87,DUBAI INVESTMENT PARK FIRST,مجمع دبي للاستثمار الأول
2001,7657,14,101,DUBAI INVESTMENT PARK FIRST,مجمع دبي للاستثمار الأول
2002,7657,20,121,DUBAI INVESTMENT PARK FIRST,مجمع دبي للاستثمار الأول
2003,7657,20,141,DUBAI INVESTMENT PARK FIRST,مجمع دبي للاستثمار الأول
2004,7657,36,177,DUBAI INVESTMENT PARK FIRST,مجمع دبي للاستثمار الأول
2005,7657,32,209,DUBAI INVESTMENT PARK FIRST,مجمع دبي للاستثمار الأول
2006,7657,35,244,DUBAI INVESTMENT PARK FIRST,مجمع دبي للاستثمار الأول
2007,7657,36,280,DUBAI INVESTMENT PARK FIRST,مجمع دبي للاستثمار الأول
2008,7657,39,319,DUBAI INVESTMENT PARK FIRST,مجمع دبي للاستثمار الأول
2009,7657,26,345,DUBAI INVESTMENT PARK FIRST,مجمع دبي للاستثمار الأول
2010,7657,46,391,DUBAI INVESTMENT PARK FIRST,مجمع دبي للاستثمار الأول
2011,7657,59,450,DUBAI INVESTMENT PARK FIRST,مجمع دبي للاستثمار الأول
2012,7657,65,515,DUBAI INVESTMENT PARK FIRST,مجمع دبي للاستثمار الأول
2013,7657,72,587,DUBAI INVESTMENT PARK FIRST,مجمع دبي للاستثمار الأول
2014,7657,75,662,DUBAI INVESTMENT PARK FIRST,مجمع دبي للاستثمار الأول
2015,7657,96,758,DUBAI INVESTMENT PARK FIRST,مجمع دبي للاستثمار الأول
2016,7657,107,865,DUBAI INVESTMENT PARK FIRST,مجمع دبي للاستثمار الأول
2017,7657,83,948,DUBAI INVESTMENT PARK FIRST,مجمع دبي للاستثمار الأول
2018,7657,101,1049,DUBAI INVESTMENT PARK FIRST,مجمع دبي للاستثمار الأول
2019,7657,123,1172,DUBAI INVESTMENT PARK FIRST,مجمع دبي للاستثمار الأول
2020,7657,133,1305,DUBAI INVESTMENT PARK FIRST,مجمع دبي للاستثمار الأول
2021,7657,0,1305,DUBAI INVESTMENT PARK FIRST,مجمع دبي للاستثمار الأول
1963,7737,0,0,AL BARSHA SECOND,البرشاء الثانية
1964,7737,0,0,AL BARSHA SECOND,البرشاء الثانية
1965,7737,0,0,AL BARSHA SECOND,البرشاء الثانية
1966,7737,0,0,AL BARSHA SECOND,البرشاء الثانية
1967,7737,0,0,AL BARSHA SECOND,البرشاء الثانية
1968,7737,0,0,AL BARSHA SECOND,البرشاء الثانية
1969,7737,0,0,AL BARSHA SECOND,البرشاء الثانية
1970,7737,0,0,AL BARSHA SECOND,البرشاء الثانية
1971,7737,0,0,AL BARSHA SECOND,البرشاء الثانية
1972,7737,0,0,AL BARSHA SECOND,البرشاء الثانية
1973,7737,0,0,AL BARSHA SECOND,البرشاء الثانية
1974,7737,0,0,AL BARSHA SECOND,البرشاء الثانية
1975,7737,0,0,AL BARSHA SECOND,البرشاء الثانية
1976,7737,0,0,AL BARSHA SECOND,البرشاء الثانية
1977,7737,1,1,AL BARSHA SECOND,البرشاء الثانية
1978,7737,0,1,AL BARSHA SECOND,البرشاء الثانية
1979,7737,1,2,AL BARSHA SECOND,البرشاء الثانية
1980,7737,0,2,AL BARSHA SECOND,البرشاء الثانية
1981,7737,1,3,AL BARSHA SECOND,البرشاء الثانية
1982,7737,1,4,AL BARSHA SECOND,البرشاء الثانية
1983,7737,0,4,AL BARSHA SECOND,البرشاء الثانية
1984,7737,0,4,AL BARSHA SECOND,البرشاء الثانية
1985,7737,1,5,AL BARSHA SECOND,البرشاء الثانية
1986,7737,0,5,AL BARSHA SECOND,البرشاء الثانية
1987,7737,0,5,AL BARSHA SECOND,البرشاء الثانية
1988,7737,0,5,AL BARSHA SECOND,البرشاء الثانية
1989,7737,0,5,AL BARSHA SECOND,البرشاء الثانية
1990,7737,0,5,AL BARSHA SECOND,البرشاء الثانية
1991,7737,0,5,AL BARSHA SECOND,البرشاء الثانية
1992,7737,0,5,AL BARSHA SECOND,البرشاء الثانية
1993,7737,1,6,AL BARSHA SECOND,البرشاء الثانية
1994,7737,2,8,AL BARSHA SECOND,البرشاء الثانية
1995,7737,0,8,AL BARSHA SECOND,البرشاء الثانية
1996,7737,0,8,AL BARSHA SECOND,البرشاء الثانية
1997,7737,1,9,AL BARSHA SECOND,البرشاء الثانية
1998,7737,0,9,AL BARSHA SECOND,البرشاء الثانية
1999,7737,0,9,AL BARSHA SECOND,البرشاء الثانية
2000,7737,0,9,AL BARSHA SECOND,البرشاء الثانية
2001,7737,4,13,AL BARSHA SECOND,البرشاء الثانية
2002,7737,0,13,AL BARSHA SECOND,البرشاء الثانية
2003,7737,2,15,AL BARSHA SECOND,البرشاء الثانية
2004,7737,3,18,AL BARSHA SECOND,البرشاء الثانية
2005,7737,3,21,AL BARSHA SECOND,البرشاء الثانية
2006,7737,2,23,AL BARSHA SECOND,البرشاء الثانية
2007,7737,1,24,AL BARSHA SECOND,البرشاء الثانية
2008,7737,2,26,AL BARSHA SECOND,البرشاء الثانية
2009,7737,3,29,AL BARSHA SECOND,البرشاء الثانية
2010,7737,4,33,AL BARSHA SECOND,البرشاء الثانية
2011,7737,9,42,AL BARSHA SECOND,البرشاء الثانية
2012,7737,7,49,AL BARSHA SECOND,البرشاء الثانية
2013,7737,9,58,AL BARSHA SECOND,البرشاء الثانية
2014,7737,13,71,AL BARSHA SECOND,البرشاء الثانية
2015,7737,12,83,AL BARSHA SECOND,البرشاء الثانية
2016,7737,12,95,AL BARSHA SECOND,البرشاء الثانية
2017,7737,18,113,AL BARSHA SECOND,البرشاء الثانية
2018,7737,23,136,AL BARSHA SECOND,البرشاء الثانية
2019,7737,43,179,AL BARSHA SECOND,البرشاء الثانية
2020,7737,104,283,AL BARSHA SECOND,البرشاء الثانية
2021,7737,0,283,AL BARSHA SECOND,البرشاء الثانية
1963,7777,0,0,GHADEER BARASHY,غدير براشي
1964,7777,0,0,GHADEER BARASHY,غدير براشي
1965,7777,0,0,GHADEER BARASHY,غدير براشي
1966,7777,0,0,GHADEER BARASHY,غدير براشي
1967,7777,0,0,GHADEER BARASHY,غدير براشي
1968,7777,0,0,GHADEER BARASHY,غدير براشي
1969,7777,0,0,GHADEER BARASHY,غدير براشي
1970,7777,0,0,GHADEER BARASHY,غدير براشي
1971,7777,0,0,GHADEER BARASHY,غدير براشي
1972,7777,0,0,GHADEER BARASHY,غدير براشي
1973,7777,0,0,GHADEER BARASHY,غدير براشي
1974,7777,0,0,GHADEER BARASHY,غدير براشي
1975,7777,0,0,GHADEER BARASHY,غدير براشي
1976,7777,0,0,GHADEER BARASHY,غدير براشي
1977,7777,0,0,GHADEER BARASHY,غدير براشي
1978,7777,0,0,GHADEER BARASHY,غدير براشي
1979,7777,0,0,GHADEER BARASHY,غدير براشي
1980,7777,0,0,GHADEER BARASHY,غدير براشي
1981,7777,0,0,GHADEER BARASHY,غدير براشي
1982,7777,0,0,GHADEER BARASHY,غدير براشي
1983,7777,0,0,GHADEER BARASHY,غدير براشي
1984,7777,0,0,GHADEER BARASHY,غدير براشي
1985,7777,0,0,GHADEER BARASHY,غدير براشي
1986,7777,0,0,GHADEER BARASHY,غدير براشي
1987,7777,0,0,GHADEER BARASHY,غدير براشي
1988,7777,0,0,GHADEER BARASHY,غدير براشي
1989,7777,0,0,GHADEER BARASHY,غدير براشي
1990,7777,0,0,GHADEER BARASHY,غدير براشي
1991,7777,0,0,GHADEER BARASHY,غدير براشي
1992,7777,0,0,GHADEER BARASHY,غدير براشي
1993,7777,0,0,GHADEER BARASHY,غدير براشي
1994,7777,0,0,GHADEER BARASHY,غدير براشي
1995,7777,0,0,GHADEER BARASHY,غدير براشي
1996,7777,0,0,GHADEER BARASHY,غدير براشي
1997,7777,0,0,GHADEER BARASHY,غدير براشي
1998,7777,0,0,GHADEER BARASHY,غدير براشي
1999,7777,0,0,GHADEER BARASHY,غدير براشي
2000,7777,0,0,GHADEER BARASHY,غدير براشي
2001,7777,0,0,GHADEER BARASHY,غدير براشي
2002,7777,0,0,GHADEER BARASHY,غدير براشي
2003,7777,0,0,GHADEER BARASHY,غدير براشي
2004,7777,0,0,GHADEER BARASHY,غدير براشي
2005,7777,0,0,GHADEER BARASHY,غدير براشي
2006,7777,0,0,GHADEER BARASHY,غدير براشي
2007,7777,0,0,GHADEER BARASHY,غدير براشي
2008,7777,0,0,GHADEER BARASHY,غدير براشي
2009,7777,0,0,GHADEER BARASHY,غدير براشي
2010,7777,0,0,GHADEER BARASHY,غدير براشي
2011,7777,0,0,GHADEER BARASHY,غدير براشي
2012,7777,1,1,GHADEER BARASHY,غدير براشي
2013,7777,0,1,GHADEER BARASHY,غدير براشي
2014,7777,1,2,GHADEER BARASHY,غدير براشي
2015,7777,0,2,GHADEER BARASHY,غدير براشي
2016,7777,0,2,GHADEER BARASHY,غدير براشي
2017,7777,0,2,GHADEER BARASHY,غدير براشي
2018,7777,2,4,GHADEER BARASHY,غدير براشي
2019,7777,2,6,GHADEER BARASHY,غدير براشي
2020,7777,32,38,GHADEER BARASHY,غدير براشي
2021,7777,0,38,GHADEER BARASHY,غدير براشي
1963,7817,4,4,AL KHABAISI,الخبيصي
1964,7817,0,4,AL KHABAISI,الخبيصي
1965,7817,0,4,AL KHABAISI,الخبيصي
1966,7817,0,4,AL KHABAISI,الخبيصي
1967,7817,3,7,AL KHABAISI,الخبيصي
1968,7817,1,8,AL KHABAISI,الخبيصي
1969,7817,1,9,AL KHABAISI,الخبيصي
1970,7817,1,10,AL KHABAISI,الخبيصي
1971,7817,0,10,AL KHABAISI,الخبيصي
1972,7817,1,11,AL KHABAISI,الخبيصي
1973,7817,1,12,AL KHABAISI,الخبيصي
1974,7817,4,16,AL KHABAISI,الخبيصي
1975,7817,6,22,AL KHABAISI,الخبيصي
1976,7817,5,27,AL KHABAISI,الخبيصي
1977,7817,3,30,AL KHABAISI,الخبيصي
1978,7817,0,30,AL KHABAISI,الخبيصي
1979,7817,6,36,AL KHABAISI,الخبيصي
1980,7817,5,41,AL KHABAISI,الخبيصي
1981,7817,1,42,AL KHABAISI,الخبيصي
1982,7817,9,51,AL KHABAISI,الخبيصي
1983,7817,1,52,AL KHABAISI,الخبيصي
1984,7817,4,56,AL KHABAISI,الخبيصي
1985,7817,7,63,AL KHABAISI,الخبيصي
1986,7817,5,68,AL KHABAISI,الخبيصي
1987,7817,9,77,AL KHABAISI,الخبيصي
1988,7817,7,84,AL KHABAISI,الخبيصي
1989,7817,7,91,AL KHABAISI,الخبيصي
1990,7817,10,101,AL KHABAISI,الخبيصي
1991,7817,6,107,AL KHABAISI,الخبيصي
1992,7817,12,119,AL KHABAISI,الخبيصي
1993,7817,10,129,AL KHABAISI,الخبيصي
1994,7817,9,138,AL KHABAISI,الخبيصي
1995,7817,11,149,AL KHABAISI,الخبيصي
1996,7817,15,164,AL KHABAISI,الخبيصي
1997,7817,14,178,AL KHABAISI,الخبيصي
1998,7817,7,185,AL KHABAISI,الخبيصي
1999,7817,13,198,AL KHABAISI,الخبيصي
2000,7817,22,220,AL KHABAISI,الخبيصي
2001,7817,13,233,AL KHABAISI,الخبيصي
2002,7817,26,259,AL KHABAISI,الخبيصي
2003,7817,31,290,AL KHABAISI,الخبيصي
2004,7817,44,334,AL KHABAISI,الخبيصي
2005,7817,26,360,AL KHABAISI,الخبيصي
2006,7817,34,394,AL KHABAISI,الخبيصي
2007,7817,45,439,AL KHABAISI,الخبيصي
2008,7817,37,476,AL KHABAISI,الخبيصي
2009,7817,30,506,AL KHABAISI,الخبيصي
2010,7817,51,557,AL KHABAISI,الخبيصي
2011,7817,52,609,AL KHABAISI,الخبيصي
2012,7817,65,674,AL KHABAISI,الخبيصي
2013,7817,77,751,AL KHABAISI,الخبيصي
2014,7817,88,839,AL KHABAISI,الخبيصي
2015,7817,107,946,AL KHABAISI,الخبيصي
2016,7817,88,1034,AL KHABAISI,الخبيصي
2017,7817,114,1148,AL KHABAISI,الخبيصي
2018,7817,127,1275,AL KHABAISI,الخبيصي
2019,7817,220,1495,AL KHABAISI,الخبيصي
2020,7817,946,2441,AL KHABAISI,الخبيصي
2021,7817,0,2441,AL KHABAISI,الخبيصي
1963,7937,0,0,AL QOUZ IND.FIRST,القوز الصناعية الأولى
1964,7937,0,0,AL QOUZ IND.FIRST,القوز الصناعية الأولى
1965,7937,0,0,AL QOUZ IND.FIRST,القوز الصناعية الأولى
1966,7937,0,0,AL QOUZ IND.FIRST,القوز الصناعية الأولى
1967,7937,0,0,AL QOUZ IND.FIRST,القوز الصناعية الأولى
1968,7937,0,0,AL QOUZ IND.FIRST,القوز الصناعية الأولى
1969,7937,0,0,AL QOUZ IND.FIRST,القوز الصناعية الأولى
1970,7937,0,0,AL QOUZ IND.FIRST,القوز الصناعية الأولى
1971,7937,0,0,AL QOUZ IND.FIRST,القوز الصناعية الأولى
1972,7937,0,0,AL QOUZ IND.FIRST,القوز الصناعية الأولى
1973,7937,0,0,AL QOUZ IND.FIRST,القوز الصناعية الأولى
1974,7937,0,0,AL QOUZ IND.FIRST,القوز الصناعية الأولى
1975,7937,1,1,AL QOUZ IND.FIRST,القوز الصناعية الأولى
1976,7937,4,5,AL QOUZ IND.FIRST,القوز الصناعية الأولى
1977,7937,1,6,AL QOUZ IND.FIRST,القوز الصناعية الأولى
1978,7937,0,6,AL QOUZ IND.FIRST,القوز الصناعية الأولى
1979,7937,1,7,AL QOUZ IND.FIRST,القوز الصناعية الأولى
1980,7937,1,8,AL QOUZ IND.FIRST,القوز الصناعية الأولى
1981,7937,1,9,AL QOUZ IND.FIRST,القوز الصناعية الأولى
1982,7937,4,13,AL QOUZ IND.FIRST,القوز الصناعية الأولى
1983,7937,2,15,AL QOUZ IND.FIRST,القوز الصناعية الأولى
1984,7937,1,16,AL QOUZ IND.FIRST,القوز الصناعية الأولى
1985,7937,0,16,AL QOUZ IND.FIRST,القوز الصناعية الأولى
1986,7937,0,16,AL QOUZ IND.FIRST,القوز الصناعية الأولى
1987,7937,0,16,AL QOUZ IND.FIRST,القوز الصناعية الأولى
1988,7937,2,18,AL QOUZ IND.FIRST,القوز الصناعية الأولى
1989,7937,4,22,AL QOUZ IND.FIRST,القوز الصناعية الأولى
1990,7937,2,24,AL QOUZ IND.FIRST,القوز الصناعية الأولى
1991,7937,2,26,AL QOUZ IND.FIRST,القوز الصناعية الأولى
1992,7937,3,29,AL QOUZ IND.FIRST,القوز الصناعية الأولى
1993,7937,4,33,AL QOUZ IND.FIRST,القوز الصناعية الأولى
1994,7937,2,35,AL QOUZ IND.FIRST,القوز الصناعية الأولى
1995,7937,4,39,AL QOUZ IND.FIRST,القوز الصناعية الأولى
1996,7937,3,42,AL QOUZ IND.FIRST,القوز الصناعية الأولى
1997,7937,2,44,AL QOUZ IND.FIRST,القوز الصناعية الأولى
1998,7937,3,47,AL QOUZ IND.FIRST,القوز الصناعية الأولى
1999,7937,7,54,AL QOUZ IND.FIRST,القوز الصناعية الأولى
2000,7937,7,61,AL QOUZ IND.FIRST,القوز الصناعية الأولى
2001,7937,13,74,AL QOUZ IND.FIRST,القوز الصناعية الأولى
2002,7937,15,89,AL QOUZ IND.FIRST,القوز الصناعية الأولى
2003,7937,15,104,AL QOUZ IND.FIRST,القوز الصناعية الأولى
2004,7937,15,119,AL QOUZ IND.FIRST,القوز الصناعية الأولى
2005,7937,9,128,AL QOUZ IND.FIRST,القوز الصناعية الأولى
2006,7937,18,146,AL QOUZ IND.FIRST,القوز الصناعية الأولى
2007,7937,18,164,AL QOUZ IND.FIRST,القوز الصناعية الأولى
2008,7937,10,174,AL QOUZ IND.FIRST,القوز الصناعية الأولى
2009,7937,17,191,AL QOUZ IND.FIRST,القوز الصناعية الأولى
2010,7937,9,200,AL QOUZ IND.FIRST,القوز الصناعية الأولى
2011,7937,3,203,AL QOUZ IND.FIRST,القوز الصناعية الأولى
2012,7937,5,208,AL QOUZ IND.FIRST,القوز الصناعية الأولى
2013,7937,4,212,AL QOUZ IND.FIRST,القوز الصناعية الأولى
2014,7937,4,216,AL QOUZ IND.FIRST,القوز الصناعية الأولى
2015,7937,2,218,AL QOUZ IND.FIRST,القوز الصناعية الأولى
2016,7937,1,219,AL QOUZ IND.FIRST,القوز الصناعية الأولى
2017,7937,0,219,AL QOUZ IND.FIRST,القوز الصناعية الأولى
2018,7937,2,221,AL QOUZ IND.FIRST,القوز الصناعية الأولى
2019,7937,3,224,AL QOUZ IND.FIRST,القوز الصناعية الأولى
2020,7937,3,227,AL QOUZ IND.FIRST,القوز الصناعية الأولى
2021,7937,0,227,AL QOUZ IND.FIRST,القوز الصناعية الأولى
1963,7977,0,0,AL BARSHA SOUTH SECOND,البرشاء جنوب الثانية
1964,7977,0,0,AL BARSHA SOUTH SECOND,البرشاء جنوب الثانية
1965,7977,0,0,AL BARSHA SOUTH SECOND,البرشاء جنوب الثانية
1966,7977,0,0,AL BARSHA SOUTH SECOND,البرشاء جنوب الثانية
1967,7977,0,0,AL BARSHA SOUTH SECOND,البرشاء جنوب الثانية
1968,7977,0,0,AL BARSHA SOUTH SECOND,البرشاء جنوب الثانية
1969,7977,0,0,AL BARSHA SOUTH SECOND,البرشاء جنوب الثانية
1970,7977,0,0,AL BARSHA SOUTH SECOND,البرشاء جنوب الثانية
1971,7977,0,0,AL BARSHA SOUTH SECOND,البرشاء جنوب الثانية
1972,7977,0,0,AL BARSHA SOUTH SECOND,البرشاء جنوب الثانية
1973,7977,0,0,AL BARSHA SOUTH SECOND,البرشاء جنوب الثانية
1974,7977,0,0,AL BARSHA SOUTH SECOND,البرشاء جنوب الثانية
1975,7977,0,0,AL BARSHA SOUTH SECOND,البرشاء جنوب الثانية
1976,7977,0,0,AL BARSHA SOUTH SECOND,البرشاء جنوب الثانية
1977,7977,0,0,AL BARSHA SOUTH SECOND,البرشاء جنوب الثانية
1978,7977,0,0,AL BARSHA SOUTH SECOND,البرشاء جنوب الثانية
1979,7977,0,0,AL BARSHA SOUTH SECOND,البرشاء جنوب الثانية
1980,7977,0,0,AL BARSHA SOUTH SECOND,البرشاء جنوب الثانية
1981,7977,0,0,AL BARSHA SOUTH SECOND,البرشاء جنوب الثانية
1982,7977,0,0,AL BARSHA SOUTH SECOND,البرشاء جنوب الثانية
1983,7977,0,0,AL BARSHA SOUTH SECOND,البرشاء جنوب الثانية
1984,7977,0,0,AL BARSHA SOUTH SECOND,البرشاء جنوب الثانية
1985,7977,0,0,AL BARSHA SOUTH SECOND,البرشاء جنوب الثانية
1986,7977,0,0,AL BARSHA SOUTH SECOND,البرشاء جنوب الثانية
1987,7977,0,0,AL BARSHA SOUTH SECOND,البرشاء جنوب الثانية
1988,7977,0,0,AL BARSHA SOUTH SECOND,البرشاء جنوب الثانية
1989,7977,0,0,AL BARSHA SOUTH SECOND,البرشاء جنوب الثانية
1990,7977,0,0,AL BARSHA SOUTH SECOND,البرشاء جنوب الثانية
1991,7977,0,0,AL BARSHA SOUTH SECOND,البرشاء جنوب الثانية
1992,7977,0,0,AL BARSHA SOUTH SECOND,البرشاء جنوب الثانية
1993,7977,0,0,AL BARSHA SOUTH SECOND,البرشاء جنوب الثانية
1994,7977,0,0,AL BARSHA SOUTH SECOND,البرشاء جنوب الثانية
1995,7977,0,0,AL BARSHA SOUTH SECOND,البرشاء جنوب الثانية
1996,7977,0,0,AL BARSHA SOUTH SECOND,البرشاء جنوب الثانية
1997,7977,0,0,AL BARSHA SOUTH SECOND,البرشاء جنوب الثانية
1998,7977,0,0,AL BARSHA SOUTH SECOND,البرشاء جنوب الثانية
1999,7977,0,0,AL BARSHA SOUTH SECOND,البرشاء جنوب الثانية
2000,7977,0,0,AL BARSHA SOUTH SECOND,البرشاء جنوب الثانية
2001,7977,0,0,AL BARSHA SOUTH SECOND,البرشاء جنوب الثانية
2002,7977,0,0,AL BARSHA SOUTH SECOND,البرشاء جنوب الثانية
2003,7977,0,0,AL BARSHA SOUTH SECOND,البرشاء جنوب الثانية
2004,7977,0,0,AL BARSHA SOUTH SECOND,البرشاء جنوب الثانية
2005,7977,0,0,AL BARSHA SOUTH SECOND,البرشاء جنوب الثانية
2006,7977,0,0,AL BARSHA SOUTH SECOND,البرشاء جنوب الثانية
2007,7977,1,1,AL BARSHA SOUTH SECOND,البرشاء جنوب الثانية
2008,7977,1,2,AL BARSHA SOUTH SECOND,البرشاء جنوب الثانية
2009,7977,0,2,AL BARSHA SOUTH SECOND,البرشاء جنوب الثانية
2010,7977,0,2,AL BARSHA SOUTH SECOND,البرشاء جنوب الثانية
2011,7977,3,5,AL BARSHA SOUTH SECOND,البرشاء جنوب الثانية
2012,7977,1,6,AL BARSHA SOUTH SECOND,البرشاء جنوب الثانية
2013,7977,0,6,AL BARSHA SOUTH SECOND,البرشاء جنوب الثانية
2014,7977,2,8,AL BARSHA SOUTH SECOND,البرشاء جنوب الثانية
2015,7977,1,9,AL BARSHA SOUTH SECOND,البرشاء جنوب الثانية
2016,7977,3,12,AL BARSHA SOUTH SECOND,البرشاء جنوب الثانية
2017,7977,2,14,AL BARSHA SOUTH SECOND,البرشاء جنوب الثانية
2018,7977,11,25,AL BARSHA SOUTH SECOND,البرشاء جنوب الثانية
2019,7977,12,37,AL BARSHA SOUTH SECOND,البرشاء جنوب الثانية
2020,7977,32,69,AL BARSHA SOUTH SECOND,البرشاء جنوب الثانية
2021,7977,0,69,AL BARSHA SOUTH SECOND,البرشاء جنوب الثانية
1963,8017,5,5,PORT SAEED,بور سعيد
1964,8017,0,5,PORT SAEED,بور سعيد
1965,8017,0,5,PORT SAEED,بور سعيد
1966,8017,1,6,PORT SAEED,بور سعيد
1967,8017,1,7,PORT SAEED,بور سعيد
1968,8017,0,7,PORT SAEED,بور سعيد
1969,8017,1,8,PORT SAEED,بور سعيد
1970,8017,2,10,PORT SAEED,بور سعيد
1971,8017,1,11,PORT SAEED,بور سعيد
1972,8017,1,12,PORT SAEED,بور سعيد
1973,8017,1,13,PORT SAEED,بور سعيد
1974,8017,1,14,PORT SAEED,بور سعيد
1975,8017,0,14,PORT SAEED,بور سعيد
1976,8017,5,19,PORT SAEED,بور سعيد
1977,8017,3,22,PORT SAEED,بور سعيد
1978,8017,4,26,PORT SAEED,بور سعيد
1979,8017,5,31,PORT SAEED,بور سعيد
1980,8017,6,37,PORT SAEED,بور سعيد
1981,8017,5,42,PORT SAEED,بور سعيد
1982,8017,7,49,PORT SAEED,بور سعيد
1983,8017,6,55,PORT SAEED,بور سعيد
1984,8017,4,59,PORT SAEED,بور سعيد
1985,8017,9,68,PORT SAEED,بور سعيد
1986,8017,12,80,PORT SAEED,بور سعيد
1987,8017,2,82,PORT SAEED,بور سعيد
1988,8017,12,94,PORT SAEED,بور سعيد
1989,8017,12,106,PORT SAEED,بور سعيد
1990,8017,6,112,PORT SAEED,بور سعيد
1991,8017,14,126,PORT SAEED,بور سعيد
1992,8017,12,138,PORT SAEED,بور سعيد
1993,8017,16,154,PORT SAEED,بور سعيد
1994,8017,13,167,PORT SAEED,بور سعيد
1995,8017,17,184,PORT SAEED,بور سعيد
1996,8017,25,209,PORT SAEED,بور سعيد
1997,8017,41,250,PORT SAEED,بور سعيد
1998,8017,27,277,PORT SAEED,بور سعيد
1999,8017,26,303,PORT SAEED,بور سعيد
2000,8017,27,330,PORT SAEED,بور سعيد
2001,8017,55,385,PORT SAEED,بور سعيد
2002,8017,49,434,PORT SAEED,بور سعيد
2003,8017,53,487,PORT SAEED,بور سعيد
2004,8017,79,566,PORT SAEED,بور سعيد
2005,8017,69,635,PORT SAEED,بور سعيد
2006,8017,97,732,PORT SAEED,بور سعيد
2007,8017,94,826,PORT SAEED,بور سعيد
2008,8017,96,922,PORT SAEED,بور سعيد
2009,8017,64,986,PORT SAEED,بور سعيد
2010,8017,101,1087,PORT SAEED,بور سعيد
2011,8017,112,1199,PORT SAEED,بور سعيد
2012,8017,204,1403,PORT SAEED,بور سعيد
2013,8017,176,1579,PORT SAEED,بور سعيد
2014,8017,218,1797,PORT SAEED,بور سعيد
2015,8017,288,2085,PORT SAEED,بور سعيد
2016,8017,264,2349,PORT SAEED,بور سعيد
2017,8017,289,2638,PORT SAEED,بور سعيد
2018,8017,312,2950,PORT SAEED,بور سعيد
2019,8017,530,3480,PORT SAEED,بور سعيد
2020,8017,1117,4597,PORT SAEED,بور سعيد
2021,8017,0,4597,PORT SAEED,بور سعيد
1963,8057,0,0,AL THANYAH THIRD,الثنيه الثالثة
1964,8057,0,0,AL THANYAH THIRD,الثنيه الثالثة
1965,8057,0,0,AL THANYAH THIRD,الثنيه الثالثة
1966,8057,0,0,AL THANYAH THIRD,الثنيه الثالثة
1967,8057,0,0,AL THANYAH THIRD,الثنيه الثالثة
1968,8057,0,0,AL THANYAH THIRD,الثنيه الثالثة
1969,8057,0,0,AL THANYAH THIRD,الثنيه الثالثة
1970,8057,0,0,AL THANYAH THIRD,الثنيه الثالثة
1971,8057,1,1,AL THANYAH THIRD,الثنيه الثالثة
1972,8057,0,1,AL THANYAH THIRD,الثنيه الثالثة
1973,8057,0,1,AL THANYAH THIRD,الثنيه الثالثة
1974,8057,0,1,AL THANYAH THIRD,الثنيه الثالثة
1975,8057,0,1,AL THANYAH THIRD,الثنيه الثالثة
1976,8057,0,1,AL THANYAH THIRD,الثنيه الثالثة
1977,8057,0,1,AL THANYAH THIRD,الثنيه الثالثة
1978,8057,0,1,AL THANYAH THIRD,الثنيه الثالثة
1979,8057,0,1,AL THANYAH THIRD,الثنيه الثالثة
1980,8057,0,1,AL THANYAH THIRD,الثنيه الثالثة
1981,8057,0,1,AL THANYAH THIRD,الثنيه الثالثة
1982,8057,1,2,AL THANYAH THIRD,الثنيه الثالثة
1983,8057,0,2,AL THANYAH THIRD,الثنيه الثالثة
1984,8057,0,2,AL THANYAH THIRD,الثنيه الثالثة
1985,8057,1,3,AL THANYAH THIRD,الثنيه الثالثة
1986,8057,0,3,AL THANYAH THIRD,الثنيه الثالثة
1987,8057,0,3,AL THANYAH THIRD,الثنيه الثالثة
1988,8057,1,4,AL THANYAH THIRD,الثنيه الثالثة
1989,8057,1,5,AL THANYAH THIRD,الثنيه الثالثة
1990,8057,0,5,AL THANYAH THIRD,الثنيه الثالثة
1991,8057,0,5,AL THANYAH THIRD,الثنيه الثالثة
1992,8057,0,5,AL THANYAH THIRD,الثنيه الثالثة
1993,8057,1,6,AL THANYAH THIRD,الثنيه الثالثة
1994,8057,1,7,AL THANYAH THIRD,الثنيه الثالثة
1995,8057,1,8,AL THANYAH THIRD,الثنيه الثالثة
1996,8057,1,9,AL THANYAH THIRD,الثنيه الثالثة
1997,8057,0,9,AL THANYAH THIRD,الثنيه الثالثة
1998,8057,2,11,AL THANYAH THIRD,الثنيه الثالثة
1999,8057,0,11,AL THANYAH THIRD,الثنيه الثالثة
2000,8057,1,12,AL THANYAH THIRD,الثنيه الثالثة
2001,8057,2,14,AL THANYAH THIRD,الثنيه الثالثة
2002,8057,3,17,AL THANYAH THIRD,الثنيه الثالثة
2003,8057,1,18,AL THANYAH THIRD,الثنيه الثالثة
2004,8057,2,20,AL THANYAH THIRD,الثنيه الثالثة
2005,8057,3,23,AL THANYAH THIRD,الثنيه الثالثة
2006,8057,6,29,AL THANYAH THIRD,الثنيه الثالثة
2007,8057,9,38,AL THANYAH THIRD,الثنيه الثالثة
2008,8057,3,41,AL THANYAH THIRD,الثنيه الثالثة
2009,8057,5,46,AL THANYAH THIRD,الثنيه الثالثة
2010,8057,5,51,AL THANYAH THIRD,الثنيه الثالثة
2011,8057,4,55,AL THANYAH THIRD,الثنيه الثالثة
2012,8057,7,62,AL THANYAH THIRD,الثنيه الثالثة
2013,8057,9,71,AL THANYAH THIRD,الثنيه الثالثة
2014,8057,16,87,AL THANYAH THIRD,الثنيه الثالثة
2015,8057,13,100,AL THANYAH THIRD,الثنيه الثالثة
2016,8057,14,114,AL THANYAH THIRD,الثنيه الثالثة
2017,8057,12,126,AL THANYAH THIRD,الثنيه الثالثة
2018,8057,33,159,AL THANYAH THIRD,الثنيه الثالثة
2019,8057,43,202,AL THANYAH THIRD,الثنيه الثالثة
2020,8057,56,258,AL THANYAH THIRD,الثنيه الثالثة
2021,8057,0,258,AL THANYAH THIRD,الثنيه الثالثة
1963,8097,0,0,AL HEBIAH THIRD,الحبيه الثالثة
1964,8097,0,0,AL HEBIAH THIRD,الحبيه الثالثة
1965,8097,0,0,AL HEBIAH THIRD,الحبيه الثالثة
1966,8097,0,0,AL HEBIAH THIRD,الحبيه الثالثة
1967,8097,0,0,AL HEBIAH THIRD,الحبيه الثالثة
1968,8097,0,0,AL HEBIAH THIRD,الحبيه الثالثة
1969,8097,0,0,AL HEBIAH THIRD,الحبيه الثالثة
1970,8097,0,0,AL HEBIAH THIRD,الحبيه الثالثة
1971,8097,0,0,AL HEBIAH THIRD,الحبيه الثالثة
1972,8097,0,0,AL HEBIAH THIRD,الحبيه الثالثة
1973,8097,0,0,AL HEBIAH THIRD,الحبيه الثالثة
1974,8097,0,0,AL HEBIAH THIRD,الحبيه الثالثة
1975,8097,0,0,AL HEBIAH THIRD,الحبيه الثالثة
1976,8097,0,0,AL HEBIAH THIRD,الحبيه الثالثة
1977,8097,0,0,AL HEBIAH THIRD,الحبيه الثالثة
1978,8097,0,0,AL HEBIAH THIRD,الحبيه الثالثة
1979,8097,0,0,AL HEBIAH THIRD,الحبيه الثالثة
1980,8097,0,0,AL HEBIAH THIRD,الحبيه الثالثة
1981,8097,0,0,AL HEBIAH THIRD,الحبيه الثالثة
1982,8097,0,0,AL HEBIAH THIRD,الحبيه الثالثة
1983,8097,0,0,AL HEBIAH THIRD,الحبيه الثالثة
1984,8097,0,0,AL HEBIAH THIRD,الحبيه الثالثة
1985,8097,0,0,AL HEBIAH THIRD,الحبيه الثالثة
1986,8097,0,0,AL HEBIAH THIRD,الحبيه الثالثة
1987,8097,0,0,AL HEBIAH THIRD,الحبيه الثالثة
1988,8097,0,0,AL HEBIAH THIRD,الحبيه الثالثة
1989,8097,0,0,AL HEBIAH THIRD,الحبيه الثالثة
1990,8097,0,0,AL HEBIAH THIRD,الحبيه الثالثة
1991,8097,0,0,AL HEBIAH THIRD,الحبيه الثالثة
1992,8097,0,0,AL HEBIAH THIRD,الحبيه الثالثة
1993,8097,0,0,AL HEBIAH THIRD,الحبيه الثالثة
1994,8097,0,0,AL HEBIAH THIRD,الحبيه الثالثة
1995,8097,0,0,AL HEBIAH THIRD,الحبيه الثالثة
1996,8097,0,0,AL HEBIAH THIRD,الحبيه الثالثة
1997,8097,0,0,AL HEBIAH THIRD,الحبيه الثالثة
1998,8097,0,0,AL HEBIAH THIRD,الحبيه الثالثة
1999,8097,0,0,AL HEBIAH THIRD,الحبيه الثالثة
2000,8097,0,0,AL HEBIAH THIRD,الحبيه الثالثة
2001,8097,0,0,AL HEBIAH THIRD,الحبيه الثالثة
2002,8097,0,0,AL HEBIAH THIRD,الحبيه الثالثة
2003,8097,0,0,AL HEBIAH THIRD,الحبيه الثالثة
2004,8097,0,0,AL HEBIAH THIRD,الحبيه الثالثة
2005,8097,0,0,AL HEBIAH THIRD,الحبيه الثالثة
2006,8097,0,0,AL HEBIAH THIRD,الحبيه الثالثة
2007,8097,0,0,AL HEBIAH THIRD,الحبيه الثالثة
2008,8097,0,0,AL HEBIAH THIRD,الحبيه الثالثة
2009,8097,0,0,AL HEBIAH THIRD,الحبيه الثالثة
2010,8097,0,0,AL HEBIAH THIRD,الحبيه الثالثة
2011,8097,0,0,AL HEBIAH THIRD,الحبيه الثالثة
2012,8097,0,0,AL HEBIAH THIRD,الحبيه الثالثة
2013,8097,0,0,AL HEBIAH THIRD,الحبيه الثالثة
2014,8097,0,0,AL HEBIAH THIRD,الحبيه الثالثة
2015,8097,2,2,AL HEBIAH THIRD,الحبيه الثالثة
2016,8097,3,5,AL HEBIAH THIRD,الحبيه الثالثة
2017,8097,2,7,AL HEBIAH THIRD,الحبيه الثالثة
2018,8097,2,9,AL HEBIAH THIRD,الحبيه الثالثة
2019,8097,9,18,AL HEBIAH THIRD,الحبيه الثالثة
2020,8097,17,35,AL HEBIAH THIRD,الحبيه الثالثة
2021,8097,0,35,AL HEBIAH THIRD,الحبيه الثالثة
1963,8137,0,0,"ZAA'BEEL SECOND",زعبيل الثانية
1964,8137,0,0,"ZAA'BEEL SECOND",زعبيل الثانية
1965,8137,0,0,"ZAA'BEEL SECOND",زعبيل الثانية
1966,8137,0,0,"ZAA'BEEL SECOND",زعبيل الثانية
1967,8137,0,0,"ZAA'BEEL SECOND",زعبيل الثانية
1968,8137,0,0,"ZAA'BEEL SECOND",زعبيل الثانية
1969,8137,0,0,"ZAA'BEEL SECOND",زعبيل الثانية
1970,8137,0,0,"ZAA'BEEL SECOND",زعبيل الثانية
1971,8137,0,0,"ZAA'BEEL SECOND",زعبيل الثانية
1972,8137,0,0,"ZAA'BEEL SECOND",زعبيل الثانية
1973,8137,0,0,"ZAA'BEEL SECOND",زعبيل الثانية
1974,8137,0,0,"ZAA'BEEL SECOND",زعبيل الثانية
1975,8137,0,0,"ZAA'BEEL SECOND",زعبيل الثانية
1976,8137,0,0,"ZAA'BEEL SECOND",زعبيل الثانية
1977,8137,0,0,"ZAA'BEEL SECOND",زعبيل الثانية
1978,8137,0,0,"ZAA'BEEL SECOND",زعبيل الثانية
1979,8137,0,0,"ZAA'BEEL SECOND",زعبيل الثانية
1980,8137,0,0,"ZAA'BEEL SECOND",زعبيل الثانية
1981,8137,0,0,"ZAA'BEEL SECOND",زعبيل الثانية
1982,8137,0,0,"ZAA'BEEL SECOND",زعبيل الثانية
1983,8137,1,1,"ZAA'BEEL SECOND",زعبيل الثانية
1984,8137,2,3,"ZAA'BEEL SECOND",زعبيل الثانية
1985,8137,0,3,"ZAA'BEEL SECOND",زعبيل الثانية
1986,8137,0,3,"ZAA'BEEL SECOND",زعبيل الثانية
1987,8137,0,3,"ZAA'BEEL SECOND",زعبيل الثانية
1988,8137,1,4,"ZAA'BEEL SECOND",زعبيل الثانية
1989,8137,0,4,"ZAA'BEEL SECOND",زعبيل الثانية
1990,8137,0,4,"ZAA'BEEL SECOND",زعبيل الثانية
1991,8137,0,4,"ZAA'BEEL SECOND",زعبيل الثانية
1992,8137,3,7,"ZAA'BEEL SECOND",زعبيل الثانية
1993,8137,0,7,"ZAA'BEEL SECOND",زعبيل الثانية
1994,8137,1,8,"ZAA'BEEL SECOND",زعبيل الثانية
1995,8137,0,8,"ZAA'BEEL SECOND",زعبيل الثانية
1996,8137,0,8,"ZAA'BEEL SECOND",زعبيل الثانية
1997,8137,0,8,"ZAA'BEEL SECOND",زعبيل الثانية
1998,8137,0,8,"ZAA'BEEL SECOND",زعبيل الثانية
1999,8137,1,9,"ZAA'BEEL SECOND",زعبيل الثانية
2000,8137,2,11,"ZAA'BEEL SECOND",زعبيل الثانية
2001,8137,1,12,"ZAA'BEEL SECOND",زعبيل الثانية
2002,8137,1,13,"ZAA'BEEL SECOND",زعبيل الثانية
2003,8137,4,17,"ZAA'BEEL SECOND",زعبيل الثانية
2004,8137,4,21,"ZAA'BEEL SECOND",زعبيل الثانية
2005,8137,6,27,"ZAA'BEEL SECOND",زعبيل الثانية
2006,8137,3,30,"ZAA'BEEL SECOND",زعبيل الثانية
2007,8137,7,37,"ZAA'BEEL SECOND",زعبيل الثانية
2008,8137,1,38,"ZAA'BEEL SECOND",زعبيل الثانية
2009,8137,4,42,"ZAA'BEEL SECOND",زعبيل الثانية
2010,8137,2,44,"ZAA'BEEL SECOND",زعبيل الثانية
2011,8137,3,47,"ZAA'BEEL SECOND",زعبيل الثانية
2012,8137,7,54,"ZAA'BEEL SECOND",زعبيل الثانية
2013,8137,5,59,"ZAA'BEEL SECOND",زعبيل الثانية
2014,8137,6,65,"ZAA'BEEL SECOND",زعبيل الثانية
2015,8137,6,71,"ZAA'BEEL SECOND",زعبيل الثانية
2016,8137,15,86,"ZAA'BEEL SECOND",زعبيل الثانية
2017,8137,16,102,"ZAA'BEEL SECOND",زعبيل الثانية
2018,8137,18,120,"ZAA'BEEL SECOND",زعبيل الثانية
2019,8137,28,148,"ZAA'BEEL SECOND",زعبيل الثانية
2020,8137,28,176,"ZAA'BEEL SECOND",زعبيل الثانية
2021,8137,0,176,"ZAA'BEEL SECOND",زعبيل الثانية
1963,8177,0,0,HATTA,حتا
1964,8177,0,0,HATTA,حتا
1965,8177,0,0,HATTA,حتا
1966,8177,0,0,HATTA,حتا
1967,8177,0,0,HATTA,حتا
1968,8177,0,0,HATTA,حتا
1969,8177,0,0,HATTA,حتا
1970,8177,0,0,HATTA,حتا
1971,8177,0,0,HATTA,حتا
1972,8177,0,0,HATTA,حتا
1973,8177,0,0,HATTA,حتا
1974,8177,0,0,HATTA,حتا
1975,8177,0,0,HATTA,حتا
1976,8177,0,0,HATTA,حتا
1977,8177,1,1,HATTA,حتا
1978,8177,0,1,HATTA,حتا
1979,8177,0,1,HATTA,حتا
1980,8177,5,6,HATTA,حتا
1981,8177,2,8,HATTA,حتا
1982,8177,1,9,HATTA,حتا
1983,8177,4,13,HATTA,حتا
1984,8177,3,16,HATTA,حتا
1985,8177,1,17,HATTA,حتا
1986,8177,1,18,HATTA,حتا
1987,8177,2,20,HATTA,حتا
1988,8177,5,25,HATTA,حتا
1989,8177,2,27,HATTA,حتا
1990,8177,6,33,HATTA,حتا
1991,8177,1,34,HATTA,حتا
1992,8177,6,40,HATTA,حتا
1993,8177,3,43,HATTA,حتا
1994,8177,6,49,HATTA,حتا
1995,8177,0,49,HATTA,حتا
1996,8177,3,52,HATTA,حتا
1997,8177,6,58,HATTA,حتا
1998,8177,1,59,HATTA,حتا
1999,8177,2,61,HATTA,حتا
2000,8177,3,64,HATTA,حتا
2001,8177,1,65,HATTA,حتا
2002,8177,8,73,HATTA,حتا
2003,8177,5,78,HATTA,حتا
2004,8177,7,85,HATTA,حتا
2005,8177,3,88,HATTA,حتا
2006,8177,3,91,HATTA,حتا
2007,8177,13,104,HATTA,حتا
2008,8177,3,107,HATTA,حتا
2009,8177,3,110,HATTA,حتا
2010,8177,11,121,HATTA,حتا
2011,8177,8,129,HATTA,حتا
2012,8177,13,142,HATTA,حتا
2013,8177,5,147,HATTA,حتا
2014,8177,13,160,HATTA,حتا
2015,8177,7,167,HATTA,حتا
2016,8177,20,187,HATTA,حتا
2017,8177,10,197,HATTA,حتا
2018,8177,10,207,HATTA,حتا
2019,8177,21,228,HATTA,حتا
2020,8177,43,271,HATTA,حتا
2021,8177,0,271,HATTA,حتا
1963,8257,0,0,AL HEBIAH FOURTH,الحبيه الرابعة
1964,8257,0,0,AL HEBIAH FOURTH,الحبيه الرابعة
1965,8257,0,0,AL HEBIAH FOURTH,الحبيه الرابعة
1966,8257,0,0,AL HEBIAH FOURTH,الحبيه الرابعة
1967,8257,0,0,AL HEBIAH FOURTH,الحبيه الرابعة
1968,8257,0,0,AL HEBIAH FOURTH,الحبيه الرابعة
1969,8257,0,0,AL HEBIAH FOURTH,الحبيه الرابعة
1970,8257,0,0,AL HEBIAH FOURTH,الحبيه الرابعة
1971,8257,0,0,AL HEBIAH FOURTH,الحبيه الرابعة
1972,8257,0,0,AL HEBIAH FOURTH,الحبيه الرابعة
1973,8257,0,0,AL HEBIAH FOURTH,الحبيه الرابعة
1974,8257,0,0,AL HEBIAH FOURTH,الحبيه الرابعة
1975,8257,0,0,AL HEBIAH FOURTH,الحبيه الرابعة
1976,8257,0,0,AL HEBIAH FOURTH,الحبيه الرابعة
1977,8257,0,0,AL HEBIAH FOURTH,الحبيه الرابعة
1978,8257,0,0,AL HEBIAH FOURTH,الحبيه الرابعة
1979,8257,0,0,AL HEBIAH FOURTH,الحبيه الرابعة
1980,8257,0,0,AL HEBIAH FOURTH,الحبيه الرابعة
1981,8257,0,0,AL HEBIAH FOURTH,الحبيه الرابعة
1982,8257,0,0,AL HEBIAH FOURTH,الحبيه الرابعة
1983,8257,0,0,AL HEBIAH FOURTH,الحبيه الرابعة
1984,8257,0,0,AL HEBIAH FOURTH,الحبيه الرابعة
1985,8257,0,0,AL HEBIAH FOURTH,الحبيه الرابعة
1986,8257,0,0,AL HEBIAH FOURTH,الحبيه الرابعة
1987,8257,0,0,AL HEBIAH FOURTH,الحبيه الرابعة
1988,8257,0,0,AL HEBIAH FOURTH,الحبيه الرابعة
1989,8257,0,0,AL HEBIAH FOURTH,الحبيه الرابعة
1990,8257,0,0,AL HEBIAH FOURTH,الحبيه الرابعة
1991,8257,0,0,AL HEBIAH FOURTH,الحبيه الرابعة
1992,8257,0,0,AL HEBIAH FOURTH,الحبيه الرابعة
1993,8257,0,0,AL HEBIAH FOURTH,الحبيه الرابعة
1994,8257,0,0,AL HEBIAH FOURTH,الحبيه الرابعة
1995,8257,0,0,AL HEBIAH FOURTH,الحبيه الرابعة
1996,8257,0,0,AL HEBIAH FOURTH,الحبيه الرابعة
1997,8257,0,0,AL HEBIAH FOURTH,الحبيه الرابعة
1998,8257,0,0,AL HEBIAH FOURTH,الحبيه الرابعة
1999,8257,0,0,AL HEBIAH FOURTH,الحبيه الرابعة
2000,8257,0,0,AL HEBIAH FOURTH,الحبيه الرابعة
2001,8257,0,0,AL HEBIAH FOURTH,الحبيه الرابعة
2002,8257,0,0,AL HEBIAH FOURTH,الحبيه الرابعة
2003,8257,0,0,AL HEBIAH FOURTH,الحبيه الرابعة
2004,8257,1,1,AL HEBIAH FOURTH,الحبيه الرابعة
2005,8257,1,2,AL HEBIAH FOURTH,الحبيه الرابعة
2006,8257,0,2,AL HEBIAH FOURTH,الحبيه الرابعة
2007,8257,2,4,AL HEBIAH FOURTH,الحبيه الرابعة
2008,8257,3,7,AL HEBIAH FOURTH,الحبيه الرابعة
2009,8257,1,8,AL HEBIAH FOURTH,الحبيه الرابعة
2010,8257,0,8,AL HEBIAH FOURTH,الحبيه الرابعة
2011,8257,2,10,AL HEBIAH FOURTH,الحبيه الرابعة
2012,8257,1,11,AL HEBIAH FOURTH,الحبيه الرابعة
2013,8257,4,15,AL HEBIAH FOURTH,الحبيه الرابعة
2014,8257,3,18,AL HEBIAH FOURTH,الحبيه الرابعة
2015,8257,9,27,AL HEBIAH FOURTH,الحبيه الرابعة
2016,8257,2,29,AL HEBIAH FOURTH,الحبيه الرابعة
2017,8257,2,31,AL HEBIAH FOURTH,الحبيه الرابعة
2018,8257,3,34,AL HEBIAH FOURTH,الحبيه الرابعة
2019,8257,10,44,AL HEBIAH FOURTH,الحبيه الرابعة
2020,8257,28,72,AL HEBIAH FOURTH,الحبيه الرابعة
2021,8257,0,72,AL HEBIAH FOURTH,الحبيه الرابعة
1963,8297,0,0,AL THANYAH FIFTH,الثنيه الخامسة
1964,8297,0,0,AL THANYAH FIFTH,الثنيه الخامسة
1965,8297,0,0,AL THANYAH FIFTH,الثنيه الخامسة
1966,8297,0,0,AL THANYAH FIFTH,الثنيه الخامسة
1967,8297,0,0,AL THANYAH FIFTH,الثنيه الخامسة
1968,8297,0,0,AL THANYAH FIFTH,الثنيه الخامسة
1969,8297,1,1,AL THANYAH FIFTH,الثنيه الخامسة
1970,8297,0,1,AL THANYAH FIFTH,الثنيه الخامسة
1971,8297,0,1,AL THANYAH FIFTH,الثنيه الخامسة
1972,8297,0,1,AL THANYAH FIFTH,الثنيه الخامسة
1973,8297,0,1,AL THANYAH FIFTH,الثنيه الخامسة
1974,8297,0,1,AL THANYAH FIFTH,الثنيه الخامسة
1975,8297,0,1,AL THANYAH FIFTH,الثنيه الخامسة
1976,8297,0,1,AL THANYAH FIFTH,الثنيه الخامسة
1977,8297,0,1,AL THANYAH FIFTH,الثنيه الخامسة
1978,8297,0,1,AL THANYAH FIFTH,الثنيه الخامسة
1979,8297,0,1,AL THANYAH FIFTH,الثنيه الخامسة
1980,8297,0,1,AL THANYAH FIFTH,الثنيه الخامسة
1981,8297,0,1,AL THANYAH FIFTH,الثنيه الخامسة
1982,8297,0,1,AL THANYAH FIFTH,الثنيه الخامسة
1983,8297,0,1,AL THANYAH FIFTH,الثنيه الخامسة
1984,8297,0,1,AL THANYAH FIFTH,الثنيه الخامسة
1985,8297,0,1,AL THANYAH FIFTH,الثنيه الخامسة
1986,8297,0,1,AL THANYAH FIFTH,الثنيه الخامسة
1987,8297,1,2,AL THANYAH FIFTH,الثنيه الخامسة
1988,8297,0,2,AL THANYAH FIFTH,الثنيه الخامسة
1989,8297,0,2,AL THANYAH FIFTH,الثنيه الخامسة
1990,8297,0,2,AL THANYAH FIFTH,الثنيه الخامسة
1991,8297,0,2,AL THANYAH FIFTH,الثنيه الخامسة
1992,8297,0,2,AL THANYAH FIFTH,الثنيه الخامسة
1993,8297,1,3,AL THANYAH FIFTH,الثنيه الخامسة
1994,8297,0,3,AL THANYAH FIFTH,الثنيه الخامسة
1995,8297,0,3,AL THANYAH FIFTH,الثنيه الخامسة
1996,8297,1,4,AL THANYAH FIFTH,الثنيه الخامسة
1997,8297,1,5,AL THANYAH FIFTH,الثنيه الخامسة
1998,8297,0,5,AL THANYAH FIFTH,الثنيه الخامسة
1999,8297,0,5,AL THANYAH FIFTH,الثنيه الخامسة
2000,8297,0,5,AL THANYAH FIFTH,الثنيه الخامسة
2001,8297,2,7,AL THANYAH FIFTH,الثنيه الخامسة
2002,8297,1,8,AL THANYAH FIFTH,الثنيه الخامسة
2003,8297,1,9,AL THANYAH FIFTH,الثنيه الخامسة
2004,8297,0,9,AL THANYAH FIFTH,الثنيه الخامسة
2005,8297,1,10,AL THANYAH FIFTH,الثنيه الخامسة
2006,8297,2,12,AL THANYAH FIFTH,الثنيه الخامسة
2007,8297,1,13,AL THANYAH FIFTH,الثنيه الخامسة
2008,8297,3,16,AL THANYAH FIFTH,الثنيه الخامسة
2009,8297,0,16,AL THANYAH FIFTH,الثنيه الخامسة
2010,8297,0,16,AL THANYAH FIFTH,الثنيه الخامسة
2011,8297,2,18,AL THANYAH FIFTH,الثنيه الخامسة
2012,8297,5,23,AL THANYAH FIFTH,الثنيه الخامسة
2013,8297,2,25,AL THANYAH FIFTH,الثنيه الخامسة
2014,8297,3,28,AL THANYAH FIFTH,الثنيه الخامسة
2015,8297,2,30,AL THANYAH FIFTH,الثنيه الخامسة
2016,8297,3,33,AL THANYAH FIFTH,الثنيه الخامسة
2017,8297,3,36,AL THANYAH FIFTH,الثنيه الخامسة
2018,8297,3,39,AL THANYAH FIFTH,الثنيه الخامسة
2019,8297,18,57,AL THANYAH FIFTH,الثنيه الخامسة
2020,8297,48,105,AL THANYAH FIFTH,الثنيه الخامسة
2021,8297,0,105,AL THANYAH FIFTH,الثنيه الخامسة
1963,8377,0,0,AL HEBIAH SECOND,الحبيه الثانية
1964,8377,0,0,AL HEBIAH SECOND,الحبيه الثانية
1965,8377,0,0,AL HEBIAH SECOND,الحبيه الثانية
1966,8377,0,0,AL HEBIAH SECOND,الحبيه الثانية
1967,8377,0,0,AL HEBIAH SECOND,الحبيه الثانية
1968,8377,0,0,AL HEBIAH SECOND,الحبيه الثانية
1969,8377,0,0,AL HEBIAH SECOND,الحبيه الثانية
1970,8377,0,0,AL HEBIAH SECOND,الحبيه الثانية
1971,8377,0,0,AL HEBIAH SECOND,الحبيه الثانية
1972,8377,0,0,AL HEBIAH SECOND,الحبيه الثانية
1973,8377,0,0,AL HEBIAH SECOND,الحبيه الثانية
1974,8377,0,0,AL HEBIAH SECOND,الحبيه الثانية
1975,8377,0,0,AL HEBIAH SECOND,الحبيه الثانية
1976,8377,0,0,AL HEBIAH SECOND,الحبيه الثانية
1977,8377,0,0,AL HEBIAH SECOND,الحبيه الثانية
1978,8377,0,0,AL HEBIAH SECOND,الحبيه الثانية
1979,8377,0,0,AL HEBIAH SECOND,الحبيه الثانية
1980,8377,0,0,AL HEBIAH SECOND,الحبيه الثانية
1981,8377,0,0,AL HEBIAH SECOND,الحبيه الثانية
1982,8377,0,0,AL HEBIAH SECOND,الحبيه الثانية
1983,8377,0,0,AL HEBIAH SECOND,الحبيه الثانية
1984,8377,0,0,AL HEBIAH SECOND,الحبيه الثانية
1985,8377,0,0,AL HEBIAH SECOND,الحبيه الثانية
1986,8377,0,0,AL HEBIAH SECOND,الحبيه الثانية
1987,8377,0,0,AL HEBIAH SECOND,الحبيه الثانية
1988,8377,0,0,AL HEBIAH SECOND,الحبيه الثانية
1989,8377,0,0,AL HEBIAH SECOND,الحبيه الثانية
1990,8377,0,0,AL HEBIAH SECOND,الحبيه الثانية
1991,8377,0,0,AL HEBIAH SECOND,الحبيه الثانية
1992,8377,0,0,AL HEBIAH SECOND,الحبيه الثانية
1993,8377,0,0,AL HEBIAH SECOND,الحبيه الثانية
1994,8377,0,0,AL HEBIAH SECOND,الحبيه الثانية
1995,8377,0,0,AL HEBIAH SECOND,الحبيه الثانية
1996,8377,0,0,AL HEBIAH SECOND,الحبيه الثانية
1997,8377,0,0,AL HEBIAH SECOND,الحبيه الثانية
1998,8377,0,0,AL HEBIAH SECOND,الحبيه الثانية
1999,8377,0,0,AL HEBIAH SECOND,الحبيه الثانية
2000,8377,0,0,AL HEBIAH SECOND,الحبيه الثانية
2001,8377,0,0,AL HEBIAH SECOND,الحبيه الثانية
2002,8377,0,0,AL HEBIAH SECOND,الحبيه الثانية
2003,8377,0,0,AL HEBIAH SECOND,الحبيه الثانية
2004,8377,0,0,AL HEBIAH SECOND,الحبيه الثانية
2005,8377,0,0,AL HEBIAH SECOND,الحبيه الثانية
2006,8377,0,0,AL HEBIAH SECOND,الحبيه الثانية
2007,8377,0,0,AL HEBIAH SECOND,الحبيه الثانية
2008,8377,0,0,AL HEBIAH SECOND,الحبيه الثانية
2009,8377,0,0,AL HEBIAH SECOND,الحبيه الثانية
2010,8377,1,1,AL HEBIAH SECOND,الحبيه الثانية
2011,8377,0,1,AL HEBIAH SECOND,الحبيه الثانية
2012,8377,0,1,AL HEBIAH SECOND,الحبيه الثانية
2013,8377,1,2,AL HEBIAH SECOND,الحبيه الثانية
2014,8377,0,2,AL HEBIAH SECOND,الحبيه الثانية
2015,8377,1,3,AL HEBIAH SECOND,الحبيه الثانية
2016,8377,1,4,AL HEBIAH SECOND,الحبيه الثانية
2017,8377,1,5,AL HEBIAH SECOND,الحبيه الثانية
2018,8377,2,7,AL HEBIAH SECOND,الحبيه الثانية
2019,8377,1,8,AL HEBIAH SECOND,الحبيه الثانية
2020,8377,10,18,AL HEBIAH SECOND,الحبيه الثانية
2021,8377,0,18,AL HEBIAH SECOND,الحبيه الثانية
1963,8417,0,0,AL THANYAH SECOND,الثنيه الثانية
1964,8417,0,0,AL THANYAH SECOND,الثنيه الثانية
1965,8417,0,0,AL THANYAH SECOND,الثنيه الثانية
1966,8417,0,0,AL THANYAH SECOND,الثنيه الثانية
1967,8417,0,0,AL THANYAH SECOND,الثنيه الثانية
1968,8417,0,0,AL THANYAH SECOND,الثنيه الثانية
1969,8417,0,0,AL THANYAH SECOND,الثنيه الثانية
1970,8417,0,0,AL THANYAH SECOND,الثنيه الثانية
1971,8417,0,0,AL THANYAH SECOND,الثنيه الثانية
1972,8417,0,0,AL THANYAH SECOND,الثنيه الثانية
1973,8417,0,0,AL THANYAH SECOND,الثنيه الثانية
1974,8417,0,0,AL THANYAH SECOND,الثنيه الثانية
1975,8417,0,0,AL THANYAH SECOND,الثنيه الثانية
1976,8417,0,0,AL THANYAH SECOND,الثنيه الثانية
1977,8417,0,0,AL THANYAH SECOND,الثنيه الثانية
1978,8417,0,0,AL THANYAH SECOND,الثنيه الثانية
1979,8417,0,0,AL THANYAH SECOND,الثنيه الثانية
1980,8417,0,0,AL THANYAH SECOND,الثنيه الثانية
1981,8417,0,0,AL THANYAH SECOND,الثنيه الثانية
1982,8417,0,0,AL THANYAH SECOND,الثنيه الثانية
1983,8417,0,0,AL THANYAH SECOND,الثنيه الثانية
1984,8417,0,0,AL THANYAH SECOND,الثنيه الثانية
1985,8417,0,0,AL THANYAH SECOND,الثنيه الثانية
1986,8417,0,0,AL THANYAH SECOND,الثنيه الثانية
1987,8417,0,0,AL THANYAH SECOND,الثنيه الثانية
1988,8417,0,0,AL THANYAH SECOND,الثنيه الثانية
1989,8417,0,0,AL THANYAH SECOND,الثنيه الثانية
1990,8417,0,0,AL THANYAH SECOND,الثنيه الثانية
1991,8417,0,0,AL THANYAH SECOND,الثنيه الثانية
1992,8417,0,0,AL THANYAH SECOND,الثنيه الثانية
1993,8417,0,0,AL THANYAH SECOND,الثنيه الثانية
1994,8417,0,0,AL THANYAH SECOND,الثنيه الثانية
1995,8417,0,0,AL THANYAH SECOND,الثنيه الثانية
1996,8417,0,0,AL THANYAH SECOND,الثنيه الثانية
1997,8417,0,0,AL THANYAH SECOND,الثنيه الثانية
1998,8417,0,0,AL THANYAH SECOND,الثنيه الثانية
1999,8417,0,0,AL THANYAH SECOND,الثنيه الثانية
2000,8417,1,1,AL THANYAH SECOND,الثنيه الثانية
2001,8417,0,1,AL THANYAH SECOND,الثنيه الثانية
2002,8417,0,1,AL THANYAH SECOND,الثنيه الثانية
2003,8417,0,1,AL THANYAH SECOND,الثنيه الثانية
2004,8417,1,2,AL THANYAH SECOND,الثنيه الثانية
2005,8417,0,2,AL THANYAH SECOND,الثنيه الثانية
2006,8417,0,2,AL THANYAH SECOND,الثنيه الثانية
2007,8417,1,3,AL THANYAH SECOND,الثنيه الثانية
2008,8417,0,3,AL THANYAH SECOND,الثنيه الثانية
2009,8417,1,4,AL THANYAH SECOND,الثنيه الثانية
2010,8417,0,4,AL THANYAH SECOND,الثنيه الثانية
2011,8417,1,5,AL THANYAH SECOND,الثنيه الثانية
2012,8417,1,6,AL THANYAH SECOND,الثنيه الثانية
2013,8417,2,8,AL THANYAH SECOND,الثنيه الثانية
2014,8417,3,11,AL THANYAH SECOND,الثنيه الثانية
2015,8417,1,12,AL THANYAH SECOND,الثنيه الثانية
2016,8417,2,14,AL THANYAH SECOND,الثنيه الثانية
2017,8417,0,14,AL THANYAH SECOND,الثنيه الثانية
2018,8417,3,17,AL THANYAH SECOND,الثنيه الثانية
2019,8417,2,19,AL THANYAH SECOND,الثنيه الثانية
2020,8417,0,19,AL THANYAH SECOND,الثنيه الثانية
2021,8417,0,19,AL THANYAH SECOND,الثنيه الثانية
1963,8497,0,0,AL WASL,الوصل
1964,8497,0,0,AL WASL,الوصل
1965,8497,0,0,AL WASL,الوصل
1966,8497,0,0,AL WASL,الوصل
1967,8497,0,0,AL WASL,الوصل
1968,8497,0,0,AL WASL,الوصل
1969,8497,0,0,AL WASL,الوصل
1970,8497,1,1,AL WASL,الوصل
1971,8497,0,1,AL WASL,الوصل
1972,8497,0,1,AL WASL,الوصل
1973,8497,0,1,AL WASL,الوصل
1974,8497,2,3,AL WASL,الوصل
1975,8497,2,5,AL WASL,الوصل
1976,8497,2,7,AL WASL,الوصل
1977,8497,2,9,AL WASL,الوصل
1978,8497,1,10,AL WASL,الوصل
1979,8497,0,10,AL WASL,الوصل
1980,8497,0,10,AL WASL,الوصل
1981,8497,2,12,AL WASL,الوصل
1982,8497,2,14,AL WASL,الوصل
1983,8497,4,18,AL WASL,الوصل
1984,8497,3,21,AL WASL,الوصل
1985,8497,0,21,AL WASL,الوصل
1986,8497,4,25,AL WASL,الوصل
1987,8497,1,26,AL WASL,الوصل
1988,8497,6,32,AL WASL,الوصل
1989,8497,4,36,AL WASL,الوصل
1990,8497,4,40,AL WASL,الوصل
1991,8497,3,43,AL WASL,الوصل
1992,8497,4,47,AL WASL,الوصل
1993,8497,2,49,AL WASL,الوصل
1994,8497,3,52,AL WASL,الوصل
1995,8497,3,55,AL WASL,الوصل
1996,8497,4,59,AL WASL,الوصل
1997,8497,7,66,AL WASL,الوصل
1998,8497,5,71,AL WASL,الوصل
1999,8497,5,76,AL WASL,الوصل
2000,8497,9,85,AL WASL,الوصل
2001,8497,16,101,AL WASL,الوصل
2002,8497,11,112,AL WASL,الوصل
2003,8497,15,127,AL WASL,الوصل
2004,8497,15,142,AL WASL,الوصل
2005,8497,19,161,AL WASL,الوصل
2006,8497,12,173,AL WASL,الوصل
2007,8497,30,203,AL WASL,الوصل
2008,8497,11,214,AL WASL,الوصل
2009,8497,13,227,AL WASL,الوصل
2010,8497,21,248,AL WASL,الوصل
2011,8497,23,271,AL WASL,الوصل
2012,8497,19,290,AL WASL,الوصل
2013,8497,42,332,AL WASL,الوصل
2014,8497,34,366,AL WASL,الوصل
2015,8497,42,408,AL WASL,الوصل
2016,8497,82,490,AL WASL,الوصل
2017,8497,51,541,AL WASL,الوصل
2018,8497,73,614,AL WASL,الوصل
2019,8497,69,683,AL WASL,الوصل
2020,8497,156,839,AL WASL,الوصل
2021,8497,0,839,AL WASL,الوصل
1963,8537,0,0,AL BARAHA,البراحة
1964,8537,0,0,AL BARAHA,البراحة
1965,8537,0,0,AL BARAHA,البراحة
1966,8537,0,0,AL BARAHA,البراحة
1967,8537,0,0,AL BARAHA,البراحة
1968,8537,0,0,AL BARAHA,البراحة
1969,8537,1,1,AL BARAHA,البراحة
1970,8537,0,1,AL BARAHA,البراحة
1971,8537,1,2,AL BARAHA,البراحة
1972,8537,0,2,AL BARAHA,البراحة
1973,8537,0,2,AL BARAHA,البراحة
1974,8537,0,2,AL BARAHA,البراحة
1975,8537,0,2,AL BARAHA,البراحة
1976,8537,0,2,AL BARAHA,البراحة
1977,8537,2,4,AL BARAHA,البراحة
1978,8537,1,5,AL BARAHA,البراحة
1979,8537,0,5,AL BARAHA,البراحة
1980,8537,3,8,AL BARAHA,البراحة
1981,8537,4,12,AL BARAHA,البراحة
1982,8537,0,12,AL BARAHA,البراحة
1983,8537,2,14,AL BARAHA,البراحة
1984,8537,1,15,AL BARAHA,البراحة
1985,8537,3,18,AL BARAHA,البراحة
1986,8537,4,22,AL BARAHA,البراحة
1987,8537,1,23,AL BARAHA,البراحة
1988,8537,6,29,AL BARAHA,البراحة
1989,8537,8,37,AL BARAHA,البراحة
1990,8537,6,43,AL BARAHA,البراحة
1991,8537,9,52,AL BARAHA,البراحة
1992,8537,5,57,AL BARAHA,البراحة
1993,8537,0,57,AL BARAHA,البراحة
1994,8537,7,64,AL BARAHA,البراحة
1995,8537,3,67,AL BARAHA,البراحة
1996,8537,9,76,AL BARAHA,البراحة
1997,8537,6,82,AL BARAHA,البراحة
1998,8537,5,87,AL BARAHA,البراحة
1999,8537,8,95,AL BARAHA,البراحة
2000,8537,13,108,AL BARAHA,البراحة
2001,8537,9,117,AL BARAHA,البراحة
2002,8537,12,129,AL BARAHA,البراحة
2003,8537,9,138,AL BARAHA,البراحة
2004,8537,17,155,AL BARAHA,البراحة
2005,8537,7,162,AL BARAHA,البراحة
2006,8537,6,168,AL BARAHA,البراحة
2007,8537,10,178,AL BARAHA,البراحة
2008,8537,10,188,AL BARAHA,البراحة
2009,8537,10,198,AL BARAHA,البراحة
2010,8537,13,211,AL BARAHA,البراحة
2011,8537,15,226,AL BARAHA,البراحة
2012,8537,17,243,AL BARAHA,البراحة
2013,8537,14,257,AL BARAHA,البراحة
2014,8537,18,275,AL BARAHA,البراحة
2015,8537,18,293,AL BARAHA,البراحة
2016,8537,18,311,AL BARAHA,البراحة
2017,8537,18,329,AL BARAHA,البراحة
2018,8537,34,363,AL BARAHA,البراحة
2019,8537,42,405,AL BARAHA,البراحة
2020,8537,77,482,AL BARAHA,البراحة
2021,8537,0,482,AL BARAHA,البراحة
1963,8577,0,0,HOR AL ANZ,هور العنز
1964,8577,0,0,HOR AL ANZ,هور العنز
1965,8577,0,0,HOR AL ANZ,هور العنز
1966,8577,0,0,HOR AL ANZ,هور العنز
1967,8577,0,0,HOR AL ANZ,هور العنز
1968,8577,0,0,HOR AL ANZ,هور العنز
1969,8577,0,0,HOR AL ANZ,هور العنز
1970,8577,0,0,HOR AL ANZ,هور العنز
1971,8577,0,0,HOR AL ANZ,هور العنز
1972,8577,0,0,HOR AL ANZ,هور العنز
1973,8577,0,0,HOR AL ANZ,هور العنز
1974,8577,0,0,HOR AL ANZ,هور العنز
1975,8577,0,0,HOR AL ANZ,هور العنز
1976,8577,0,0,HOR AL ANZ,هور العنز
1977,8577,0,0,HOR AL ANZ,هور العنز
1978,8577,0,0,HOR AL ANZ,هور العنز
1979,8577,0,0,HOR AL ANZ,هور العنز
1980,8577,0,0,HOR AL ANZ,هور العنز
1981,8577,0,0,HOR AL ANZ,هور العنز
1982,8577,0,0,HOR AL ANZ,هور العنز
1983,8577,0,0,HOR AL ANZ,هور العنز
1984,8577,0,0,HOR AL ANZ,هور العنز
1985,8577,0,0,HOR AL ANZ,هور العنز
1986,8577,0,0,HOR AL ANZ,هور العنز
1987,8577,0,0,HOR AL ANZ,هور العنز
1988,8577,0,0,HOR AL ANZ,هور العنز
1989,8577,0,0,HOR AL ANZ,هور العنز
1990,8577,0,0,HOR AL ANZ,هور العنز
1991,8577,0,0,HOR AL ANZ,هور العنز
1992,8577,0,0,HOR AL ANZ,هور العنز
1993,8577,0,0,HOR AL ANZ,هور العنز
1994,8577,0,0,HOR AL ANZ,هور العنز
1995,8577,0,0,HOR AL ANZ,هور العنز
1996,8577,0,0,HOR AL ANZ,هور العنز
1997,8577,0,0,HOR AL ANZ,هور العنز
1998,8577,0,0,HOR AL ANZ,هور العنز
1999,8577,0,0,HOR AL ANZ,هور العنز
2000,8577,0,0,HOR AL ANZ,هور العنز
2001,8577,0,0,HOR AL ANZ,هور العنز
2002,8577,0,0,HOR AL ANZ,هور العنز
2003,8577,0,0,HOR AL ANZ,هور العنز
2004,8577,0,0,HOR AL ANZ,هور العنز
2005,8577,0,0,HOR AL ANZ,هور العنز
2006,8577,0,0,HOR AL ANZ,هور العنز
2007,8577,0,0,HOR AL ANZ,هور العنز
2008,8577,0,0,HOR AL ANZ,هور العنز
2009,8577,0,0,HOR AL ANZ,هور العنز
2010,8577,0,0,HOR AL ANZ,هور العنز
2011,8577,0,0,HOR AL ANZ,هور العنز
2012,8577,0,0,HOR AL ANZ,هور العنز
2013,8577,0,0,HOR AL ANZ,هور العنز
2014,8577,0,0,HOR AL ANZ,هور العنز
2015,8577,0,0,HOR AL ANZ,هور العنز
2016,8577,0,0,HOR AL ANZ,هور العنز
2017,8577,0,0,HOR AL ANZ,هور العنز
2018,8577,0,0,HOR AL ANZ,هور العنز
2019,8577,3,3,HOR AL ANZ,هور العنز
2020,8577,21,24,HOR AL ANZ,هور العنز
2021,8577,0,24,HOR AL ANZ,هور العنز
1963,8617,0,0,RAS AL KHOR IND. SECOND,رأس الخور الصناعية الثانية
1964,8617,0,0,RAS AL KHOR IND. SECOND,رأس الخور الصناعية الثانية
1965,8617,1,1,RAS AL KHOR IND. SECOND,رأس الخور الصناعية الثانية
1966,8617,3,4,RAS AL KHOR IND. SECOND,رأس الخور الصناعية الثانية
1967,8617,0,4,RAS AL KHOR IND. SECOND,رأس الخور الصناعية الثانية
1968,8617,0,4,RAS AL KHOR IND. SECOND,رأس الخور الصناعية الثانية
1969,8617,0,4,RAS AL KHOR IND. SECOND,رأس الخور الصناعية الثانية
1970,8617,2,6,RAS AL KHOR IND. SECOND,رأس الخور الصناعية الثانية
1971,8617,0,6,RAS AL KHOR IND. SECOND,رأس الخور الصناعية الثانية
1972,8617,0,6,RAS AL KHOR IND. SECOND,رأس الخور الصناعية الثانية
1973,8617,1,7,RAS AL KHOR IND. SECOND,رأس الخور الصناعية الثانية
1974,8617,1,8,RAS AL KHOR IND. SECOND,رأس الخور الصناعية الثانية
1975,8617,0,8,RAS AL KHOR IND. SECOND,رأس الخور الصناعية الثانية
1976,8617,4,12,RAS AL KHOR IND. SECOND,رأس الخور الصناعية الثانية
1977,8617,1,13,RAS AL KHOR IND. SECOND,رأس الخور الصناعية الثانية
1978,8617,1,14,RAS AL KHOR IND. SECOND,رأس الخور الصناعية الثانية
1979,8617,2,16,RAS AL KHOR IND. SECOND,رأس الخور الصناعية الثانية
1980,8617,3,19,RAS AL KHOR IND. SECOND,رأس الخور الصناعية الثانية
1981,8617,7,26,RAS AL KHOR IND. SECOND,رأس الخور الصناعية الثانية
1982,8617,4,30,RAS AL KHOR IND. SECOND,رأس الخور الصناعية الثانية
1983,8617,3,33,RAS AL KHOR IND. SECOND,رأس الخور الصناعية الثانية
1984,8617,3,36,RAS AL KHOR IND. SECOND,رأس الخور الصناعية الثانية
1985,8617,2,38,RAS AL KHOR IND. SECOND,رأس الخور الصناعية الثانية
1986,8617,6,44,RAS AL KHOR IND. SECOND,رأس الخور الصناعية الثانية
1987,8617,3,47,RAS AL KHOR IND. SECOND,رأس الخور الصناعية الثانية
1988,8617,1,48,RAS AL KHOR IND. SECOND,رأس الخور الصناعية الثانية
1989,8617,2,50,RAS AL KHOR IND. SECOND,رأس الخور الصناعية الثانية
1990,8617,11,61,RAS AL KHOR IND. SECOND,رأس الخور الصناعية الثانية
1991,8617,7,68,RAS AL KHOR IND. SECOND,رأس الخور الصناعية الثانية
1992,8617,14,82,RAS AL KHOR IND. SECOND,رأس الخور الصناعية الثانية
1993,8617,7,89,RAS AL KHOR IND. SECOND,رأس الخور الصناعية الثانية
1994,8617,7,96,RAS AL KHOR IND. SECOND,رأس الخور الصناعية الثانية
1995,8617,9,105,RAS AL KHOR IND. SECOND,رأس الخور الصناعية الثانية
1996,8617,6,111,RAS AL KHOR IND. SECOND,رأس الخور الصناعية الثانية
1997,8617,12,123,RAS AL KHOR IND. SECOND,رأس الخور الصناعية الثانية
1998,8617,5,128,RAS AL KHOR IND. SECOND,رأس الخور الصناعية الثانية
1999,8617,12,140,RAS AL KHOR IND. SECOND,رأس الخور الصناعية الثانية
2000,8617,5,145,RAS AL KHOR IND. SECOND,رأس الخور الصناعية الثانية
2001,8617,15,160,RAS AL KHOR IND. SECOND,رأس الخور الصناعية الثانية
2002,8617,17,177,RAS AL KHOR IND. SECOND,رأس الخور الصناعية الثانية
2003,8617,16,193,RAS AL KHOR IND. SECOND,رأس الخور الصناعية الثانية
2004,8617,19,212,RAS AL KHOR IND. SECOND,رأس الخور الصناعية الثانية
2005,8617,19,231,RAS AL KHOR IND. SECOND,رأس الخور الصناعية الثانية
2006,8617,37,268,RAS AL KHOR IND. SECOND,رأس الخور الصناعية الثانية
2007,8617,22,290,RAS AL KHOR IND. SECOND,رأس الخور الصناعية الثانية
2008,8617,30,320,RAS AL KHOR IND. SECOND,رأس الخور الصناعية الثانية
2009,8617,23,343,RAS AL KHOR IND. SECOND,رأس الخور الصناعية الثانية
2010,8617,36,379,RAS AL KHOR IND. SECOND,رأس الخور الصناعية الثانية
2011,8617,38,417,RAS AL KHOR IND. SECOND,رأس الخور الصناعية الثانية
2012,8617,52,469,RAS AL KHOR IND. SECOND,رأس الخور الصناعية الثانية
2013,8617,66,535,RAS AL KHOR IND. SECOND,رأس الخور الصناعية الثانية
2014,8617,72,607,RAS AL KHOR IND. SECOND,رأس الخور الصناعية الثانية
2015,8617,73,680,RAS AL KHOR IND. SECOND,رأس الخور الصناعية الثانية
2016,8617,89,769,RAS AL KHOR IND. SECOND,رأس الخور الصناعية الثانية
2017,8617,71,840,RAS AL KHOR IND. SECOND,رأس الخور الصناعية الثانية
2018,8617,82,922,RAS AL KHOR IND. SECOND,رأس الخور الصناعية الثانية
2019,8617,132,1054,RAS AL KHOR IND. SECOND,رأس الخور الصناعية الثانية
2020,8617,308,1362,RAS AL KHOR IND. SECOND,رأس الخور الصناعية الثانية
2021,8617,0,1362,RAS AL KHOR IND. SECOND,رأس الخور الصناعية الثانية
1963,8697,0,0,JABAL ALI INDUSTRIAL FIRST,جبل علي الصناعية الأولى
1964,8697,0,0,JABAL ALI INDUSTRIAL FIRST,جبل علي الصناعية الأولى
1965,8697,1,1,JABAL ALI INDUSTRIAL FIRST,جبل علي الصناعية الأولى
1966,8697,0,1,JABAL ALI INDUSTRIAL FIRST,جبل علي الصناعية الأولى
1967,8697,0,1,JABAL ALI INDUSTRIAL FIRST,جبل علي الصناعية الأولى
1968,8697,0,1,JABAL ALI INDUSTRIAL FIRST,جبل علي الصناعية الأولى
1969,8697,0,1,JABAL ALI INDUSTRIAL FIRST,جبل علي الصناعية الأولى
1970,8697,0,1,JABAL ALI INDUSTRIAL FIRST,جبل علي الصناعية الأولى
1971,8697,2,3,JABAL ALI INDUSTRIAL FIRST,جبل علي الصناعية الأولى
1972,8697,0,3,JABAL ALI INDUSTRIAL FIRST,جبل علي الصناعية الأولى
1973,8697,0,3,JABAL ALI INDUSTRIAL FIRST,جبل علي الصناعية الأولى
1974,8697,1,4,JABAL ALI INDUSTRIAL FIRST,جبل علي الصناعية الأولى
1975,8697,0,4,JABAL ALI INDUSTRIAL FIRST,جبل علي الصناعية الأولى
1976,8697,2,6,JABAL ALI INDUSTRIAL FIRST,جبل علي الصناعية الأولى
1977,8697,1,7,JABAL ALI INDUSTRIAL FIRST,جبل علي الصناعية الأولى
1978,8697,2,9,JABAL ALI INDUSTRIAL FIRST,جبل علي الصناعية الأولى
1979,8697,2,11,JABAL ALI INDUSTRIAL FIRST,جبل علي الصناعية الأولى
1980,8697,1,12,JABAL ALI INDUSTRIAL FIRST,جبل علي الصناعية الأولى
1981,8697,0,12,JABAL ALI INDUSTRIAL FIRST,جبل علي الصناعية الأولى
1982,8697,1,13,JABAL ALI INDUSTRIAL FIRST,جبل علي الصناعية الأولى
1983,8697,2,15,JABAL ALI INDUSTRIAL FIRST,جبل علي الصناعية الأولى
1984,8697,2,17,JABAL ALI INDUSTRIAL FIRST,جبل علي الصناعية الأولى
1985,8697,2,19,JABAL ALI INDUSTRIAL FIRST,جبل علي الصناعية الأولى
1986,8697,1,20,JABAL ALI INDUSTRIAL FIRST,جبل علي الصناعية الأولى
1987,8697,1,21,JABAL ALI INDUSTRIAL FIRST,جبل علي الصناعية الأولى
1988,8697,1,22,JABAL ALI INDUSTRIAL FIRST,جبل علي الصناعية الأولى
1989,8697,0,22,JABAL ALI INDUSTRIAL FIRST,جبل علي الصناعية الأولى
1990,8697,2,24,JABAL ALI INDUSTRIAL FIRST,جبل علي الصناعية الأولى
1991,8697,1,25,JABAL ALI INDUSTRIAL FIRST,جبل علي الصناعية الأولى
1992,8697,1,26,JABAL ALI INDUSTRIAL FIRST,جبل علي الصناعية الأولى
1993,8697,2,28,JABAL ALI INDUSTRIAL FIRST,جبل علي الصناعية الأولى
1994,8697,1,29,JABAL ALI INDUSTRIAL FIRST,جبل علي الصناعية الأولى
1995,8697,4,33,JABAL ALI INDUSTRIAL FIRST,جبل علي الصناعية الأولى
1996,8697,7,40,JABAL ALI INDUSTRIAL FIRST,جبل علي الصناعية الأولى
1997,8697,2,42,JABAL ALI INDUSTRIAL FIRST,جبل علي الصناعية الأولى
1998,8697,3,45,JABAL ALI INDUSTRIAL FIRST,جبل علي الصناعية الأولى
1999,8697,4,49,JABAL ALI INDUSTRIAL FIRST,جبل علي الصناعية الأولى
2000,8697,4,53,JABAL ALI INDUSTRIAL FIRST,جبل علي الصناعية الأولى
2001,8697,3,56,JABAL ALI INDUSTRIAL FIRST,جبل علي الصناعية الأولى
2002,8697,6,62,JABAL ALI INDUSTRIAL FIRST,جبل علي الصناعية الأولى
2003,8697,11,73,JABAL ALI INDUSTRIAL FIRST,جبل علي الصناعية الأولى
2004,8697,7,80,JABAL ALI INDUSTRIAL FIRST,جبل علي الصناعية الأولى
2005,8697,5,85,JABAL ALI INDUSTRIAL FIRST,جبل علي الصناعية الأولى
2006,8697,12,97,JABAL ALI INDUSTRIAL FIRST,جبل علي الصناعية الأولى
2007,8697,15,112,JABAL ALI INDUSTRIAL FIRST,جبل علي الصناعية الأولى
2008,8697,22,134,JABAL ALI INDUSTRIAL FIRST,جبل علي الصناعية الأولى
2009,8697,17,151,JABAL ALI INDUSTRIAL FIRST,جبل علي الصناعية الأولى
2010,8697,22,173,JABAL ALI INDUSTRIAL FIRST,جبل علي الصناعية الأولى
2011,8697,20,193,JABAL ALI INDUSTRIAL FIRST,جبل علي الصناعية الأولى
2012,8697,32,225,JABAL ALI INDUSTRIAL FIRST,جبل علي الصناعية الأولى
2013,8697,27,252,JABAL ALI INDUSTRIAL FIRST,جبل علي الصناعية الأولى
2014,8697,35,287,JABAL ALI INDUSTRIAL FIRST,جبل علي الصناعية الأولى
2015,8697,31,318,JABAL ALI INDUSTRIAL FIRST,جبل علي الصناعية الأولى
2016,8697,45,363,JABAL ALI INDUSTRIAL FIRST,جبل علي الصناعية الأولى
2017,8697,45,408,JABAL ALI INDUSTRIAL FIRST,جبل علي الصناعية الأولى
2018,8697,46,454,JABAL ALI INDUSTRIAL FIRST,جبل علي الصناعية الأولى
2019,8697,41,495,JABAL ALI INDUSTRIAL FIRST,جبل علي الصناعية الأولى
2020,8697,81,576,JABAL ALI INDUSTRIAL FIRST,جبل علي الصناعية الأولى
2021,8697,0,576,JABAL ALI INDUSTRIAL FIRST,جبل علي الصناعية الأولى
1963,8737,0,0,UMM SUQEIM FIRST,أم سقيم الأولى
1964,8737,0,0,UMM SUQEIM FIRST,أم سقيم الأولى
1965,8737,0,0,UMM SUQEIM FIRST,أم سقيم الأولى
1966,8737,0,0,UMM SUQEIM FIRST,أم سقيم الأولى
1967,8737,0,0,UMM SUQEIM FIRST,أم سقيم الأولى
1968,8737,1,1,UMM SUQEIM FIRST,أم سقيم الأولى
1969,8737,0,1,UMM SUQEIM FIRST,أم سقيم الأولى
1970,8737,0,1,UMM SUQEIM FIRST,أم سقيم الأولى
1971,8737,0,1,UMM SUQEIM FIRST,أم سقيم الأولى
1972,8737,0,1,UMM SUQEIM FIRST,أم سقيم الأولى
1973,8737,0,1,UMM SUQEIM FIRST,أم سقيم الأولى
1974,8737,0,1,UMM SUQEIM FIRST,أم سقيم الأولى
1975,8737,0,1,UMM SUQEIM FIRST,أم سقيم الأولى
1976,8737,0,1,UMM SUQEIM FIRST,أم سقيم الأولى
1977,8737,1,2,UMM SUQEIM FIRST,أم سقيم الأولى
1978,8737,0,2,UMM SUQEIM FIRST,أم سقيم الأولى
1979,8737,0,2,UMM SUQEIM FIRST,أم سقيم الأولى
1980,8737,0,2,UMM SUQEIM FIRST,أم سقيم الأولى
1981,8737,1,3,UMM SUQEIM FIRST,أم سقيم الأولى
1982,8737,0,3,UMM SUQEIM FIRST,أم سقيم الأولى
1983,8737,0,3,UMM SUQEIM FIRST,أم سقيم الأولى
1984,8737,0,3,UMM SUQEIM FIRST,أم سقيم الأولى
1985,8737,0,3,UMM SUQEIM FIRST,أم سقيم الأولى
1986,8737,0,3,UMM SUQEIM FIRST,أم سقيم الأولى
1987,8737,3,6,UMM SUQEIM FIRST,أم سقيم الأولى
1988,8737,1,7,UMM SUQEIM FIRST,أم سقيم الأولى
1989,8737,2,9,UMM SUQEIM FIRST,أم سقيم الأولى
1990,8737,0,9,UMM SUQEIM FIRST,أم سقيم الأولى
1991,8737,3,12,UMM SUQEIM FIRST,أم سقيم الأولى
1992,8737,1,13,UMM SUQEIM FIRST,أم سقيم الأولى
1993,8737,1,14,UMM SUQEIM FIRST,أم سقيم الأولى
1994,8737,1,15,UMM SUQEIM FIRST,أم سقيم الأولى
1995,8737,0,15,UMM SUQEIM FIRST,أم سقيم الأولى
1996,8737,0,15,UMM SUQEIM FIRST,أم سقيم الأولى
1997,8737,2,17,UMM SUQEIM FIRST,أم سقيم الأولى
1998,8737,1,18,UMM SUQEIM FIRST,أم سقيم الأولى
1999,8737,0,18,UMM SUQEIM FIRST,أم سقيم الأولى
2000,8737,5,23,UMM SUQEIM FIRST,أم سقيم الأولى
2001,8737,2,25,UMM SUQEIM FIRST,أم سقيم الأولى
2002,8737,0,25,UMM SUQEIM FIRST,أم سقيم الأولى
2003,8737,2,27,UMM SUQEIM FIRST,أم سقيم الأولى
2004,8737,6,33,UMM SUQEIM FIRST,أم سقيم الأولى
2005,8737,4,37,UMM SUQEIM FIRST,أم سقيم الأولى
2006,8737,5,42,UMM SUQEIM FIRST,أم سقيم الأولى
2007,8737,4,46,UMM SUQEIM FIRST,أم سقيم الأولى
2008,8737,2,48,UMM SUQEIM FIRST,أم سقيم الأولى
2009,8737,1,49,UMM SUQEIM FIRST,أم سقيم الأولى
2010,8737,7,56,UMM SUQEIM FIRST,أم سقيم الأولى
2011,8737,2,58,UMM SUQEIM FIRST,أم سقيم الأولى
2012,8737,8,66,UMM SUQEIM FIRST,أم سقيم الأولى
2013,8737,4,70,UMM SUQEIM FIRST,أم سقيم الأولى
2014,8737,8,78,UMM SUQEIM FIRST,أم سقيم الأولى
2015,8737,16,94,UMM SUQEIM FIRST,أم سقيم الأولى
2016,8737,12,106,UMM SUQEIM FIRST,أم سقيم الأولى
2017,8737,13,119,UMM SUQEIM FIRST,أم سقيم الأولى
2018,8737,12,131,UMM SUQEIM FIRST,أم سقيم الأولى
2019,8737,32,163,UMM SUQEIM FIRST,أم سقيم الأولى
2020,8737,65,228,UMM SUQEIM FIRST,أم سقيم الأولى
2021,8737,0,228,UMM SUQEIM FIRST,أم سقيم الأولى
1963,8777,0,0,AL HEBIAH FIRST,الحبيه الأولى
1964,8777,0,0,AL HEBIAH FIRST,الحبيه الأولى
1965,8777,0,0,AL HEBIAH FIRST,الحبيه الأولى
1966,8777,0,0,AL HEBIAH FIRST,الحبيه الأولى
1967,8777,0,0,AL HEBIAH FIRST,الحبيه الأولى
1968,8777,0,0,AL HEBIAH FIRST,الحبيه الأولى
1969,8777,0,0,AL HEBIAH FIRST,الحبيه الأولى
1970,8777,0,0,AL HEBIAH FIRST,الحبيه الأولى
1971,8777,0,0,AL HEBIAH FIRST,الحبيه الأولى
1972,8777,0,0,AL HEBIAH FIRST,الحبيه الأولى
1973,8777,0,0,AL HEBIAH FIRST,الحبيه الأولى
1974,8777,1,1,AL HEBIAH FIRST,الحبيه الأولى
1975,8777,0,1,AL HEBIAH FIRST,الحبيه الأولى
1976,8777,1,2,AL HEBIAH FIRST,الحبيه الأولى
1977,8777,0,2,AL HEBIAH FIRST,الحبيه الأولى
1978,8777,0,2,AL HEBIAH FIRST,الحبيه الأولى
1979,8777,0,2,AL HEBIAH FIRST,الحبيه الأولى
1980,8777,0,2,AL HEBIAH FIRST,الحبيه الأولى
1981,8777,0,2,AL HEBIAH FIRST,الحبيه الأولى
1982,8777,0,2,AL HEBIAH FIRST,الحبيه الأولى
1983,8777,0,2,AL HEBIAH FIRST,الحبيه الأولى
1984,8777,0,2,AL HEBIAH FIRST,الحبيه الأولى
1985,8777,0,2,AL HEBIAH FIRST,الحبيه الأولى
1986,8777,0,2,AL HEBIAH FIRST,الحبيه الأولى
1987,8777,0,2,AL HEBIAH FIRST,الحبيه الأولى
1988,8777,1,3,AL HEBIAH FIRST,الحبيه الأولى
1989,8777,0,3,AL HEBIAH FIRST,الحبيه الأولى
1990,8777,0,3,AL HEBIAH FIRST,الحبيه الأولى
1991,8777,0,3,AL HEBIAH FIRST,الحبيه الأولى
1992,8777,0,3,AL HEBIAH FIRST,الحبيه الأولى
1993,8777,0,3,AL HEBIAH FIRST,الحبيه الأولى
1994,8777,2,5,AL HEBIAH FIRST,الحبيه الأولى
1995,8777,1,6,AL HEBIAH FIRST,الحبيه الأولى
1996,8777,3,9,AL HEBIAH FIRST,الحبيه الأولى
1997,8777,0,9,AL HEBIAH FIRST,الحبيه الأولى
1998,8777,1,10,AL HEBIAH FIRST,الحبيه الأولى
1999,8777,1,11,AL HEBIAH FIRST,الحبيه الأولى
2000,8777,1,12,AL HEBIAH FIRST,الحبيه الأولى
2001,8777,0,12,AL HEBIAH FIRST,الحبيه الأولى
2002,8777,1,13,AL HEBIAH FIRST,الحبيه الأولى
2003,8777,3,16,AL HEBIAH FIRST,الحبيه الأولى
2004,8777,4,20,AL HEBIAH FIRST,الحبيه الأولى
2005,8777,4,24,AL HEBIAH FIRST,الحبيه الأولى
2006,8777,3,27,AL HEBIAH FIRST,الحبيه الأولى
2007,8777,6,33,AL HEBIAH FIRST,الحبيه الأولى
2008,8777,5,38,AL HEBIAH FIRST,الحبيه الأولى
2009,8777,3,41,AL HEBIAH FIRST,الحبيه الأولى
2010,8777,11,52,AL HEBIAH FIRST,الحبيه الأولى
2011,8777,10,62,AL HEBIAH FIRST,الحبيه الأولى
2012,8777,11,73,AL HEBIAH FIRST,الحبيه الأولى
2013,8777,15,88,AL HEBIAH FIRST,الحبيه الأولى
2014,8777,10,98,AL HEBIAH FIRST,الحبيه الأولى
2015,8777,18,116,AL HEBIAH FIRST,الحبيه الأولى
2016,8777,24,140,AL HEBIAH FIRST,الحبيه الأولى
2017,8777,27,167,AL HEBIAH FIRST,الحبيه الأولى
2018,8777,25,192,AL HEBIAH FIRST,الحبيه الأولى
2019,8777,29,221,AL HEBIAH FIRST,الحبيه الأولى
2020,8777,48,269,AL HEBIAH FIRST,الحبيه الأولى
2021,8777,0,269,AL HEBIAH FIRST,الحبيه الأولى
1963,8817,0,0,WADI AL SAFA 3,وادي الصفا 3
1964,8817,0,0,WADI AL SAFA 3,وادي الصفا 3
1965,8817,0,0,WADI AL SAFA 3,وادي الصفا 3
1966,8817,0,0,WADI AL SAFA 3,وادي الصفا 3
1967,8817,0,0,WADI AL SAFA 3,وادي الصفا 3
1968,8817,0,0,WADI AL SAFA 3,وادي الصفا 3
1969,8817,0,0,WADI AL SAFA 3,وادي الصفا 3
1970,8817,0,0,WADI AL SAFA 3,وادي الصفا 3
1971,8817,0,0,WADI AL SAFA 3,وادي الصفا 3
1972,8817,0,0,WADI AL SAFA 3,وادي الصفا 3
1973,8817,0,0,WADI AL SAFA 3,وادي الصفا 3
1974,8817,0,0,WADI AL SAFA 3,وادي الصفا 3
1975,8817,0,0,WADI AL SAFA 3,وادي الصفا 3
1976,8817,0,0,WADI AL SAFA 3,وادي الصفا 3
1977,8817,0,0,WADI AL SAFA 3,وادي الصفا 3
1978,8817,0,0,WADI AL SAFA 3,وادي الصفا 3
1979,8817,0,0,WADI AL SAFA 3,وادي الصفا 3
1980,8817,0,0,WADI AL SAFA 3,وادي الصفا 3
1981,8817,0,0,WADI AL SAFA 3,وادي الصفا 3
1982,8817,0,0,WADI AL SAFA 3,وادي الصفا 3
1983,8817,0,0,WADI AL SAFA 3,وادي الصفا 3
1984,8817,0,0,WADI AL SAFA 3,وادي الصفا 3
1985,8817,0,0,WADI AL SAFA 3,وادي الصفا 3
1986,8817,0,0,WADI AL SAFA 3,وادي الصفا 3
1987,8817,0,0,WADI AL SAFA 3,وادي الصفا 3
1988,8817,0,0,WADI AL SAFA 3,وادي الصفا 3
1989,8817,0,0,WADI AL SAFA 3,وادي الصفا 3
1990,8817,0,0,WADI AL SAFA 3,وادي الصفا 3
1991,8817,1,1,WADI AL SAFA 3,وادي الصفا 3
1992,8817,0,1,WADI AL SAFA 3,وادي الصفا 3
1993,8817,0,1,WADI AL SAFA 3,وادي الصفا 3
1994,8817,1,2,WADI AL SAFA 3,وادي الصفا 3
1995,8817,0,2,WADI AL SAFA 3,وادي الصفا 3
1996,8817,0,2,WADI AL SAFA 3,وادي الصفا 3
1997,8817,1,3,WADI AL SAFA 3,وادي الصفا 3
1998,8817,0,3,WADI AL SAFA 3,وادي الصفا 3
1999,8817,0,3,WADI AL SAFA 3,وادي الصفا 3
2000,8817,0,3,WADI AL SAFA 3,وادي الصفا 3
2001,8817,1,4,WADI AL SAFA 3,وادي الصفا 3
2002,8817,1,5,WADI AL SAFA 3,وادي الصفا 3
2003,8817,0,5,WADI AL SAFA 3,وادي الصفا 3
2004,8817,1,6,WADI AL SAFA 3,وادي الصفا 3
2005,8817,0,6,WADI AL SAFA 3,وادي الصفا 3
2006,8817,2,8,WADI AL SAFA 3,وادي الصفا 3
2007,8817,2,10,WADI AL SAFA 3,وادي الصفا 3
2008,8817,1,11,WADI AL SAFA 3,وادي الصفا 3
2009,8817,1,12,WADI AL SAFA 3,وادي الصفا 3
2010,8817,3,15,WADI AL SAFA 3,وادي الصفا 3
2011,8817,4,19,WADI AL SAFA 3,وادي الصفا 3
2012,8817,2,21,WADI AL SAFA 3,وادي الصفا 3
2013,8817,1,22,WADI AL SAFA 3,وادي الصفا 3
2014,8817,4,26,WADI AL SAFA 3,وادي الصفا 3
2015,8817,2,28,WADI AL SAFA 3,وادي الصفا 3
2016,8817,1,29,WADI AL SAFA 3,وادي الصفا 3
2017,8817,6,35,WADI AL SAFA 3,وادي الصفا 3
2018,8817,3,38,WADI AL SAFA 3,وادي الصفا 3
2019,8817,7,45,WADI AL SAFA 3,وادي الصفا 3
2020,8817,37,82,WADI AL SAFA 3,وادي الصفا 3
2021,8817,0,82,WADI AL SAFA 3,وادي الصفا 3
1963,8985,0,0,NAKHLAT DEIRA,نخلة ديره
1964,8985,1,1,NAKHLAT DEIRA,نخلة ديره
1965,8985,0,1,NAKHLAT DEIRA,نخلة ديره
1966,8985,0,1,NAKHLAT DEIRA,نخلة ديره
1967,8985,0,1,NAKHLAT DEIRA,نخلة ديره
1968,8985,0,1,NAKHLAT DEIRA,نخلة ديره
1969,8985,0,1,NAKHLAT DEIRA,نخلة ديره
1970,8985,1,2,NAKHLAT DEIRA,نخلة ديره
1971,8985,0,2,NAKHLAT DEIRA,نخلة ديره
1972,8985,0,2,NAKHLAT DEIRA,نخلة ديره
1973,8985,2,4,NAKHLAT DEIRA,نخلة ديره
1974,8985,1,5,NAKHLAT DEIRA,نخلة ديره
1975,8985,1,6,NAKHLAT DEIRA,نخلة ديره
1976,8985,2,8,NAKHLAT DEIRA,نخلة ديره
1977,8985,1,9,NAKHLAT DEIRA,نخلة ديره
1978,8985,1,10,NAKHLAT DEIRA,نخلة ديره
1979,8985,1,11,NAKHLAT DEIRA,نخلة ديره
1980,8985,3,14,NAKHLAT DEIRA,نخلة ديره
1981,8985,5,19,NAKHLAT DEIRA,نخلة ديره
1982,8985,1,20,NAKHLAT DEIRA,نخلة ديره
1983,8985,0,20,NAKHLAT DEIRA,نخلة ديره
1984,8985,2,22,NAKHLAT DEIRA,نخلة ديره
1985,8985,1,23,NAKHLAT DEIRA,نخلة ديره
1986,8985,2,25,NAKHLAT DEIRA,نخلة ديره
1987,8985,3,28,NAKHLAT DEIRA,نخلة ديره
1988,8985,3,31,NAKHLAT DEIRA,نخلة ديره
1989,8985,4,35,NAKHLAT DEIRA,نخلة ديره
1990,8985,4,39,NAKHLAT DEIRA,نخلة ديره
1991,8985,6,45,NAKHLAT DEIRA,نخلة ديره
1992,8985,3,48,NAKHLAT DEIRA,نخلة ديره
1993,8985,2,50,NAKHLAT DEIRA,نخلة ديره
1994,8985,13,63,NAKHLAT DEIRA,نخلة ديره
1995,8985,0,63,NAKHLAT DEIRA,نخلة ديره
1996,8985,4,67,NAKHLAT DEIRA,نخلة ديره
1997,8985,6,73,NAKHLAT DEIRA,نخلة ديره
1998,8985,8,81,NAKHLAT DEIRA,نخلة ديره
1999,8985,9,90,NAKHLAT DEIRA,نخلة ديره
2000,8985,10,100,NAKHLAT DEIRA,نخلة ديره
2001,8985,13,113,NAKHLAT DEIRA,نخلة ديره
2002,8985,11,124,NAKHLAT DEIRA,نخلة ديره
2003,8985,9,133,NAKHLAT DEIRA,نخلة ديره
2004,8985,2,135,NAKHLAT DEIRA,نخلة ديره
2005,8985,6,141,NAKHLAT DEIRA,نخلة ديره
2006,8985,3,144,NAKHLAT DEIRA,نخلة ديره
2007,8985,3,147,NAKHLAT DEIRA,نخلة ديره
2008,8985,2,149,NAKHLAT DEIRA,نخلة ديره
2009,8985,2,151,NAKHLAT DEIRA,نخلة ديره
2010,8985,2,153,NAKHLAT DEIRA,نخلة ديره
2011,8985,2,155,NAKHLAT DEIRA,نخلة ديره
2012,8985,1,156,NAKHLAT DEIRA,نخلة ديره
2013,8985,2,158,NAKHLAT DEIRA,نخلة ديره
2014,8985,2,160,NAKHLAT DEIRA,نخلة ديره
2015,8985,0,160,NAKHLAT DEIRA,نخلة ديره
2016,8985,4,164,NAKHLAT DEIRA,نخلة ديره
2017,8985,4,168,NAKHLAT DEIRA,نخلة ديره
2018,8985,2,170,NAKHLAT DEIRA,نخلة ديره
2019,8985,4,174,NAKHLAT DEIRA,نخلة ديره
2020,8985,18,192,NAKHLAT DEIRA,نخلة ديره
2021,8985,0,192,NAKHLAT DEIRA,نخلة ديره
